aardvark=aard-vark
abattoir=ab-at-toir
abaci=ab-a-ci
abacus=ab-a-cus
abacuses=ab-a-cus-es
abalone=ab-a-lo-ne
abatis=ab-a-tis
abbacy=ab-ba-cy
abbe=ab-be
abbess=ab-bess
abbey=ab-bey
abbey=ab-bey
abbot=ab-bot
abbot=ab-bot
abbotship=ab-bot-ship
abbreviate=ab-bre-vi-ate
abbreviation=ab-bre-vi-a-tion
abdicate=ab-di-cate
abdicated=ab-di-cat-ed
abdicating=ab-di-cat-ing
abdication=ab-di-ca-tion
abdominal=ab-dom-i-nal
abdomen=ab-do-men
abduct=ab-duct
abduction=ab-duc-tion
abductor=ab-duc-tor
aberrance=ab-er-rance
aberrant=ab-er-rant
aberration=ab-er-ra-tion
abhor=ab-hor
abhorred=ab-horred
abhorrence=ab-hor-rence
abhorrent=ab-hor-rent
abhorrer=ab-hor-rer
abhorring=ab-hor-ring
abject=ab-ject
abjectly=ab-ject-ly
abjectness=ab-ject-ness
abjection=ab-jec-tion
abjure=ab-jure
abjured=ab-jured
abjuratory=ab-jur-a-to-ry
abjurer=ab-jur-er
abjuring=ab-jur-ing
abjuration=ab-ju-ra-tion
ablate=ab-late
ablated=ab-lat-ed
ablating=ab-lat-ing
ablation=ab-la-tion
ablative=ab-la-tive
ablatival=ab-la-ti-val
ablution=ab-lu-tion
abnegate=ab-ne-gate
abnegated=ab-ne-gat-ed
abnegating=ab-ne-gat-ing
abnegation=ab-ne-ga-tion
abnegator=ab-ne-ga-tor
abnormal=ab-nor-mal
abnormally=ab-nor-mal-ly
abolition=ab-o-li-tion
aboriginal=ab-o-rig-i-nal
aboriginal=ab-o-rig-i-nal
aborigine=ab-o-rig-i-ne
aborigine=ab-o-rig-i-ne
abracadabra=ab-ra-ca-dab-ra
abrogate=ab-ro-gate
abrogated=ab-ro-gat-ed
abrogating=ab-ro-gat-ing
abrogation=ab-ro-ga-tion
abrogator=ab-ro-ga-tor
abrupt=ab-rupt
abruptly=ab-rupt-ly
abruptness=ab-rupt-ness
abscess=ab-scess
abscessed=ab-scessed
abscise=ab-scise
abscised=ab-scised
abscising=ab-scis-ing
abscissa=ab-scis-sa
abscissae=ab-scis-sae
abscissas=ab-scis-sas
abscission=ab-scis-sion
abscond=ab-scond
absconder=ab-scond-er
absence=ab-sence
absent=ab-sent
absently=ab-sent-ly
absentee=ab-sen-tee
absentia=ab-sen-ti-a
absinthe=ab-sinthe
absolve=ab-solve
absolved=ab-solved
absolvable=ab-solv-a-ble
absolving=ab-solv-ing
absorb=ab-sorb
absorbed=ab-sorbed
absorbable=ab-sorb-a-ble
absorbent=ab-sorb-ent
absorbency=ab-sorb-en-cy
absorber=ab-sorb-er
absorbing=ab-sorb-ing
absorption=ab-sorp-tion
absorptive=ab-sorp-tive
absolute=ab-so-lute
absolute=ab-so-lute
absolutely=ab-so-lute-ly
absolutism=ab-so-lut-ism
absolutist=ab-so-lut-ist
absolution=ab-so-lu-tion
abstain=ab-stain
abstainer=ab-stain-er
abstention=ab-sten-tion
abstemious=ab-ste-mi-ous
abstinence=ab-sti-nence
abstinent=ab-sti-nent
abstract=ab-stract
abstracted=ab-stract-ed
abstracter=ab-stract-er
abstractly=ab-stract-ly
abstruse=ab-struse
abstrusely=ab-struse-ly
absurd=ab-surd
absurdity=ab-surd-i-ty
absurdly=ab-surd-ly
absurdness=ab-surd-ness
ace=ace
ache=ache
aching=ach-ing
achromatic=ach-ro-mat-ic
act=act
acting=act-ing
academe=ac-a-deme
academic=ac-a-dem-ic
academia=ac-a-dem-i-a
academical=ac-a-dem-i-cal
academia=ac-a-de-mi-a
accede=ac-cede
acceded=ac-ced-ed
accedence=ac-ced-ence
acceder=ac-ced-er
acceding=ac-ced-ing
accelerate=ac-cel-er-ate
accelerometer=ac-cel-er-om-e-ter
accent=ac-cent
accentual=ac-cen-tu-al
accentuate=ac-cen-tu-ate
accept=ac-cept
acceptance=ac-cept-ance
acceptable=ac-cept-a-ble
acceptably=ac-cept-a-bly
accepted=ac-cept-ed
access=ac-cess
accession=ac-ces-sion
accessible=ac-ces-si-ble
accessibly=ac-ces-si-bly
accessory=ac-ces-so-ry
accidence=ac-ci-dence
accident=ac-ci-dent
accidental=ac-ci-den-tal
acclaim=ac-claim
acclaimer=ac-claim-er
acclivity=ac-cliv-i-ty
acclimate=ac-cli-mate
acclimated=ac-cli-mat-ed
accommodate=ac-com-mo-date
accommodation=ac-com-mo-da-tion
accompanist=ac-com-pa-nist
accompaniment=ac-com-pa-ni-ment
accompany=ac-com-pa-ny
accomplice=ac-com-plice
accomplish=ac-com-plish
accord=ac-cord
accordance=ac-cord-ance
accordant=ac-cord-ant
accordable=ac-cord-a-ble
accorder=ac-cord-er
according=ac-cord-ing
accordingly=ac-cord-ing-ly
accordion=ac-cor-di-on
accost=ac-cost
accostable=ac-cost-a-ble
accosted=ac-cost-ed
account=ac-count
accountant=ac-count-ant
accounting=ac-count-ing
accouter=ac-cou-ter
accolade=ac-co-lade
accredit=ac-cred-it
accrete=ac-crete
accreted=ac-cret-ed
accreting=ac-cret-ing
accretion=ac-cre-tion
accrue=ac-crue
accrued=ac-crued
accruement=ac-crue-ment
accrual=ac-cru-al
accruing=ac-cru-ing
accursed=ac-curs-ed
accursedly=ac-curs-ed-ly
accuse=ac-cuse
accused=ac-cused
accusal=ac-cus-al
accuser=ac-cus-er
accusing=ac-cus-ing
accusingly=ac-cus-ing-ly
accustom=ac-cus-tom
accustomed=ac-cus-tomed
accumulate=ac-cu-mu-late
accurate=ac-cu-rate
accurately=ac-cu-rate-ly
accuracy=ac-cu-ra-cy
accusation=ac-cu-sa-tion
accusative=ac-cu-sa-tive
accusatory=ac-cu-sa-to-ry
acerbate=ac-er-bate
acerbated=ac-er-bat-ed
acerbating=ac-er-bat-ing
acetate=ac-e-tate
acetone=ac-e-tone
acetonic=ac-e-ton-ic
acid=ac-id
acing=ac-ing
acidosis=ac-i-do-sis
acknowledge=ac-knowl-edge
acme=ac-me
acne=ac-ne
acolyte=ac-o-lyte
aconite=ac-o-nite
acquaint=ac-quaint
acquaintance=ac-quaint-ance
acquainted=ac-quaint-ed
acquire=ac-quire
acquired=ac-quired
acquirable=ac-quir-a-ble
acquiring=ac-quir-ing
acquit=ac-quit
acquittal=ac-quit-tal
acquitted=ac-quit-ted
acquitting=ac-quit-ting
acquiesce=ac-qui-esce
acrid=ac-rid
acridly=ac-rid-ly
acrimony=ac-ri-mo-ny
acrobat=ac-ro-bat
acrobatic=ac-ro-bat-ic
acrobatics=ac-ro-bat-ics
acronym=ac-ro-nym
acrophobia=ac-ro-pho-bi-a
actin=ac-tin
actinic=ac-tin-ic
actinism=ac-tin-ism
actinium=ac-tin-i-um
action=ac-tion
actionable=ac-tion-a-ble
active=ac-tive
actively=ac-tive-ly
activeness=ac-tive-ness
activism=ac-tiv-ism
activist=ac-tiv-ist
activity=ac-tiv-i-ty
activate=ac-ti-vate
activated=ac-ti-vat-ed
activating=ac-ti-vat-ing
activation=ac-ti-va-tion
activator=ac-ti-va-tor
actor=ac-tor
actor=ac-tor
actomyosin=ac-to-my-o-sin
actress=ac-tress
actual=ac-tu-al
actualize=ac-tu-al-ize
actualized=ac-tu-al-ized
actuality=ac-tu-al-i-ty
actually=ac-tu-al-ly
actuary=ac-tu-ary
actuaries=ac-tu-ar-ies
actuarial=ac-tu-ar-i-al
actuary=ac-tu-ar-y
actuate=ac-tu-ate
actuated=ac-tu-at-ed
actuating=ac-tu-at-ing
actuation=ac-tu-a-tion
actuator=ac-tu-a-tor
acumen=ac-u-men
add=add
addable=add-a-ble
adder=add-er
addible=add-i-ble
adz=adz
adage=ad-age
adaptation=ad-ap-ta-tion
adamant=ad-a-mant
adamantine=ad-a-man-tine
addend=ad-dend
addendum=ad-den-dum
adder=ad-der
addict=ad-dict
addicted=ad-dict-ed
addiction=ad-dic-tion
addictive=ad-dic-tive
addition=ad-di-tion
additional=ad-di-tion-al
additive=ad-di-tive
addle=ad-dle
address=ad-dress
addressee=ad-dress-ee
addressing=ad-dress-ing
adduce=ad-duce
adduced=ad-duced
adducing=ad-duc-ing
adept=ad-ept
adenine=ad-e-nine
adenoid=ad-e-noid
adenoids=ad-e-noids
adequate=ad-e-quate
adequately=ad-e-quate-ly
adequacy=ad-e-qua-cy
adhere=ad-here
adhered=ad-hered
adherence=ad-her-ence
adherent=ad-her-ent
adherer=ad-her-er
adhering=ad-her-ing
adhesion=ad-he-sion
adhesional=ad-he-sion-al
adhesive=ad-he-sive
adhesively=ad-he-sive-ly
adiabatic=ad-i-a-bat-ic
adios=ad-i-os
adipose=ad-i-pose
adiposity=ad-i-pos-i-ty
adjacent=ad-ja-cent
adjacently=ad-ja-cent-ly
adjacency=ad-ja-cen-cy
adjective=ad-jec-tive
adjectival=ad-jec-ti-val
adjoin=ad-join
adjoining=ad-join-ing
adjourn=ad-journ
adjournment=ad-journ-ment
adjudge=ad-judge
adjudged=ad-judged
adjudging=ad-judg-ing
adjunct=ad-junct
adjunctly=ad-junct-ly
adjunctive=ad-junc-tive
adjure=ad-jure
adjured=ad-jured
adjuratory=ad-jur-a-to-ry
adjuring=ad-jur-ing
adjust=ad-just
adjustable=ad-just-a-ble
adjuster=ad-just-er
adjustment=ad-just-ment
adjustor=ad-jus-tor
adjudicate=ad-ju-di-cate
adjuration=ad-ju-ra-tion
adjutant=ad-ju-tant
adjutancy=ad-ju-tan-cy
adman=ad-man
administer=ad-min-is-ter
administrate=ad-min-is-trate
administration=ad-min-is-tra-tion
administrational=ad-min-is-tra-tion-al
admire=ad-mire
admired=ad-mired
admirer=ad-mir-er
admiring=ad-mir-ing
admiringly=ad-mir-ing-ly
admission=ad-mis-sion
admissible=ad-mis-si-ble
admissibly=ad-mis-si-bly
admit=ad-mit
admittance=ad-mit-tance
admitted=ad-mit-ted
admittedly=ad-mit-ted-ly
admitting=ad-mit-ting
admix=ad-mix
admixture=ad-mix-ture
admiral=ad-mi-ral
admiral=ad-mi-ral
admiralty=ad-mi-ral-ty
admirable=ad-mi-ra-ble
admirably=ad-mi-ra-bly
admiration=ad-mi-ra-tion
admonish=ad-mon-ish
admonitory=ad-mon-i-to-ry
admonition=ad-mo-ni-tion
adolescent=ad-o-les-cent
adoration=ad-o-ra-tion
adrenal=ad-re-nal
adsorb=ad-sorb
adsorbate=ad-sorb-ate
adsorbable=ad-sorb-a-ble
adsorbent=ad-sorb-ent
adsorption=ad-sorp-tion
adsorptive=ad-sorp-tive
adsorbent=ad-sor-bent
adumbrate=ad-um-brate
adumbrated=ad-um-brat-ed
adulate=ad-u-late
adulated=ad-u-lat-ed
adulating=ad-u-lat-ing
adulation=ad-u-la-tion
adulator=ad-u-la-tor
adulatory=ad-u-la-to-ry
advance=ad-vance
advanced=ad-vanced
advancer=ad-vanc-er
advances=ad-vanc-es
advancing=ad-vanc-ing
advantage=ad-van-tage
advantaged=ad-van-taged
advent=ad-vent
advent=ad-vent
adventure=ad-ven-ture
adventured=ad-ven-tured
adventurer=ad-ven-tur-er
adverb=ad-verb
adverse=ad-verse
adversely=ad-verse-ly
advert=ad-vert
adverbial=ad-ver-bi-al
adversary=ad-ver-sar-y
adversity=ad-ver-si-ty
advertise=ad-ver-tise
advertised=ad-ver-tised
advertiser=ad-ver-tis-er
advice=ad-vice
advise=ad-vise
advised=ad-vised
advisement=ad-vise-ment
advisable=ad-vis-a-ble
advisedly=ad-vis-ed-ly
adviser=ad-vis-er
advisor=ad-vi-sor
advisory=ad-vi-so-ry
advocate=ad-vo-cate
advocated=ad-vo-cat-ed
advocating=ad-vo-cat-ing
advocacy=ad-vo-ca-cy
adytum=ad-y-tum
aerate=aer-ate
aerated=aer-at-ed
aerating=aer-at-ing
aeration=aer-a-tion
aerator=aer-a-tor
aerie=aer-ie
aeries=aer-ies
aerial=aer-i-al
aerialist=aer-i-al-ist
aerially=aer-i-al-ly
aerobe=aer-obe
aerologist=aer-ol-o-gist
aerology=aer-ol-o-gy
aerobatics=aer-o-bat-ics
aerobic=aer-o-bic
aeronaut=aer-o-naut
aeronautic=aer-o-naut-ic
aerosol=aer-o-sol
aerospace=aer-o-space
aery=aer-y
aesthete=aes-thete
aesthetic=aes-thet-ic
aesthetics=aes-thet-ics
aestivate=aes-ti-vate
aestivated=aes-ti-vat-ed
aegis=ae-gis
aeon=ae-on
aeolian=ae-o-li-an
aft=aft
affair=af-fair
affairs=af-fairs
affability=af-fa-bil-i-ty
affable=af-fa-ble
affably=af-fa-bly
affect=af-fect
affected=af-fect-ed
affectedly=af-fect-ed-ly
affecter=af-fect-er
affecting=af-fect-ing
affection=af-fec-tion
affectionate=af-fec-tion-ate
afferent=af-fer-ent
affiliate=af-fil-i-ate
affiliated=af-fil-i-at-ed
affinity=af-fin-i-ty
affirm=af-firm
affirmable=af-firm-a-ble
affirmably=af-firm-a-bly
affirmation=af-fir-ma-tion
affix=af-fix
affiance=af-fi-ance
affianced=af-fi-anced
affiancing=af-fi-anc-ing
affidavit=af-fi-da-vit
afflatus=af-fla-tus
afflict=af-flict
affliction=af-flic-tion
afflictive=af-flic-tive
affluence=af-flu-ence
affluent=af-flu-ent
affluently=af-flu-ent-ly
afford=af-ford
affordable=af-ford-a-ble
afforest=af-for-est
affray=af-fray
affront=af-front
afghan=af-ghan
afghan=af-ghan
after=af-ter
afterbirth=af-ter-birth
aftercare=af-ter-care
afterdeck=af-ter-deck
afterglow=af-ter-glow
afterimage=af-ter-im-age
afterlife=af-ter-life
aftermath=af-ter-math
aftermost=af-ter-most
afternoon=af-ter-noon
afternoons=af-ter-noons
aftertaste=af-ter-taste
afterward=af-ter-ward
age=age
ageing=age-ing
ageless=age-less
agate=ag-ate
ageratum=ag-er-a-tum
agglutinin=ag-glu-ti-nin
aggrandize=ag-gran-dize
aggravate=ag-gra-vate
aggravated=ag-gra-vated
aggression=ag-gres-sion
aggressive=ag-gres-sive
aggressor=ag-gres-sor
aggregate=ag-gre-gate
aggregated=ag-gre-gat-ed
aggrieve=ag-grieve
aggrieved=ag-grieved
aggrieving=ag-griev-ing
agile=ag-ile
agilely=ag-ile-ly
agileness=ag-ile-ness
aging=ag-ing
agitate=ag-i-tate
agitated=ag-i-tat-ed
agitatedly=ag-i-tat-ed-ly
agitating=ag-i-tat-ing
agitation=ag-i-ta-tion
agitator=ag-i-ta-tor
agnostic=ag-nos-tic
agonize=ag-o-nize
agonized=ag-o-nized
agonizing=ag-o-niz-ing
agony=ag-o-ny
agriculture=ag-ri-cul-ture
agronomic=ag-ro-nom-ic
aid=aid
aide=aide
aider=aid-er
ail=ail
ailing=ail-ing
ailment=ail-ment
aim=aim
aimless=aim-less
aimlessly=aim-less-ly
ain=ain
air=air
airs=airs
airbill=air-bill
airborne=air-borne
airbrush=air-brush
aircraft=air-craft
airdrome=air-drome
airdrop=air-drop
airdropped=air-dropped
airfield=air-field
airflow=air-flow
airfoil=air-foil
airframe=air-frame
airing=air-ing
airier=air-i-er
airiest=air-i-est
airily=air-i-ly
airiness=air-i-ness
airless=air-less
airlift=air-lift
airline=air-line
airlines=air-lines
airliner=air-lin-er
airmail=air-mail
airman=air-man
airmanship=air-man-ship
airplane=air-plane
airport=air-port
airship=air-ship
airsick=air-sick
airspace=air-space
airspeed=air-speed
airstrip=air-strip
airtight=air-tight
airwaves=air-waves
airway=air-way
airworthy=air-wor-thy
airy=air-y
airy=air-y
aisle=aisle
aigrette=ai-grette
ailanthus=ai-lan-thus
aileron=ai-ler-on
akvavit=ak-va-vit
alb=alb
ale=ale
alehouse=ale-house
alehouses=ale-hous-es
alewife=ale-wife
alias=alias
all=all
allover=all-ov-er
allspice=all-spice
alms=alms
almshouse=alms-house
almshouses=alms-hous-es
alp=alp
alum=alum
alabama=al-a-bam-a
alabaster=al-a-bas-ter
albacore=al-ba-core
albatross=al-ba-tross
albeit=al-be-it
albinism=al-bi-nism
albino=al-bi-no
album=al-bum
albumen=al-bu-men
albumin=al-bu-min
albuminous=al-bu-mi-nous
alcalde=al-cal-de
alcazar=al-ca-zar
alcazar=al-ca-zar
alchemic=al-chem-ic
alchemist=al-che-mist
alchemy=al-che-my
alcove=al-cove
alcohol=al-co-hol
alcoholic=al-co-hol-ic
alcoholism=al-co-hol-ism
alder=al-der
alder=al-der
alderman=al-der-man
aldehyde=al-de-hyde
alfalfa=al-fal-fa
alfresco=al-fres-co
alga=al-ga
algae=al-gae
algal=al-gal
algebra=al-ge-bra
algebraic=al-ge-bra-ic
algorithm=al-go-rithm
alien=al-ien
alienate=al-ien-ate
alienated=al-ien-at-ed
alienating=al-ien-at-ing
alienable=al-ien-a-ble
alienation=al-ien-a-tion
alienist=al-ien-ist
alibi=al-i-bi
aliment=al-i-ment
alimentary=al-i-men-ta-ry
alimony=al-i-mo-ny
aliquant=al-i-quant
alkali=al-ka-li
alkaline=al-ka-line
alkalinize=al-ka-lin-ize
alkalinity=al-ka-lin-i-ty
alkalize=al-ka-lize
alkalized=al-ka-lized
alkalizing=al-ka-liz-ing
alkaloid=al-ka-loid
allay=al-lay
allayed=al-layed
allayer=al-lay-er
allaying=al-lay-ing
allege=al-lege
alleged=al-leged
allegedly=al-leg-ed-ly
alleger=al-leg-er
alleging=al-leg-ing
allele=al-lele
allelic=al-lel-ic
allergen=al-ler-gen
allergenic=al-ler-gen-ic
allergic=al-ler-gic
allergist=al-ler-gist
allergy=al-ler-gy
alley=al-ley
alleyway=al-ley-way
allegation=al-le-ga-tion
allegiance=al-le-giance
allegiant=al-le-giant
allegoric=al-le-gor-ic
allegorical=al-le-gor-i-cal
allegorist=al-le-go-rist
allegory=al-le-go-ry
allegretto=al-le-gret-to
allegro=al-le-gro
allegro=al-le-gro
alleluia=al-le-lu-ia
alleviate=al-le-vi-ate
alleviated=al-le-vi-at-ed
alleviator=al-le-vi-a-tor
allied=al-lied
allied=al-lied
allies=al-lies
allies=al-lies
alliterate=al-lit-er-ate
alliance=al-li-ance
alliance=al-li-ance
alliable=al-li-a-ble
alligator=al-li-ga-tor
allot=al-lot
allotment=al-lot-ment
allotropy=al-lot-ro-py
allotted=al-lot-ted
allotting=al-lot-ting
allow=al-low
allowed=al-lowed
allowance=al-low-ance
allowable=al-low-a-ble
alloy=al-loy
allocate=al-lo-cate
allocated=al-lo-cat-ed
allocating=al-lo-cat-ing
allocable=al-lo-ca-ble
allocation=al-lo-ca-tion
allotrope=al-lo-trope
allotropic=al-lo-trop-ic
allude=al-lude
alluded=al-lud-ed
alluding=al-lud-ing
allure=al-lure
allured=al-lured
allurement=al-lure-ment
alluring=al-lur-ing
alluringly=al-lur-ing-ly
allusion=al-lu-sion
allusive=al-lu-sive
allusively=al-lu-sive-ly
alluvia=al-lu-vi-a
alluvial=al-lu-vi-al
alluvium=al-lu-vi-um
alluviums=al-lu-vi-ums
ally=al-ly
alma=al-ma
alma=al-ma
almandine=al-man-dine
almanac=al-ma-nac
almightily=al-might-i-ly
almighty=al-might-y
almighty=al-might-y
almond=al-mond
almoner=al-mon-er
almost=al-most
aloe=al-oe
aloes=al-oes
alopecia=al-o-pe-ci-a
alpaca=al-pac-a
alpenhorn=al-pen-horn
alpenstock=al-pen-stock
alpha=al-pha
alpha=al-pha
alphabet=al-pha-bet
alphabetic=al-pha-bet-ic
alpine=al-pine
alpine=al-pine
already=al-read-y
also=al-so
altar=al-tar
altarpiece=al-tar-piece
alter=al-ter
alterable=al-ter-a-ble
alteration=al-ter-a-tion
alterative=al-ter-a-tive
alternate=al-ter-nate
alternated=al-ter-nat-ed
alternator=al-ter-na-tor
although=al-though
altimeter=al-tim-e-ter
altitude=al-ti-tude
alto=al-to
altogether=al-to-geth-er
altruism=al-tru-ism
altruist=al-tru-ist
altruistic=al-tru-is-tic
alum=al-um
always=al-ways
amp=amp
amaranth=am-a-ranth
amaryllis=am-a-ryl-lis
amaryllis=am-a-ryl-lis
amateur=am-a-teur
amateurish=am-a-teur-ish
amateurism=am-a-teur-ism
amative=am-a-tive
amatively=am-a-tive-ly
amatory=am-a-tory
amatory=am-a-to-ry
amazon=am-a-zon
amazon=am-a-zon
ambassador=am-bas-sa-dor
amber=am-ber
ambergris=am-ber-gris
ambiguous=am-big-u-ous
ambivalent=am-biv-a-lent
ambience=am-bi-ence
ambiences=am-bi-enc-es
ambient=am-bi-ent
ambiguity=am-bi-gu-i-ty
ambition=am-bi-tion
ambitious=am-bi-tious
ambivert=am-bi-vert
amble=am-ble
ambler=am-bler
ambler=am-bler
ambrosia=am-bro-sia
ambrosial=am-bro-sial
ambrosia=am-bro-si-a
ambush=am-bush
ambuscade=am-bus-cade
ambuscaded=am-bus-cad-ed
ambulance=am-bu-lance
ambulant=am-bu-lant
ambulate=am-bu-late
ambulated=am-bu-lat-ed
ambulating=am-bu-lat-ing
ambulation=am-bu-la-tion
ambulator=am-bu-la-tor
ambulatory=am-bu-la-to-ry
americium=am-er-i-ci-um
amethyst=am-e-thyst
amide=am-ide
amicable=am-i-ca-ble
amicably=am-i-ca-bly
amity=am-i-ty
amity=am-i-ty
ammeter=am-me-ter
ammo=am-mo
ammonia=am-mo-nia
ammonia=am-mo-ni-a
ammonium=am-mo-ni-um
ammunition=am-mu-ni-tion
amnestic=am-nes-tic
amnestied=am-nes-tied
amnesty=am-nes-ty
amnestying=am-nes-ty-ing
amnesia=am-ne-sia
amnesic=am-ne-sic
amnesia=am-ne-si-a
amnesiac=am-ne-si-ac
amortize=am-or-tize
amortized=am-or-tized
amortizing=am-or-tiz-ing
amorous=am-o-rous
amorously=am-o-rous-ly
amp=am-p
ampere=am-pere
amperage=am-per-age
ampersand=am-per-sand
amphibian=am-phib-i-an
amphibious=am-phib-i-ous
amphibole=am-phi-bole
amphora=am-pho-ra
amphorae=am-pho-rae
ample=am-ple
ampleness=am-ple-ness
amplified=am-pli-fied
amplifier=am-pli-fi-er
amplify=am-pli-fy
amplifying=am-pli-fy-ing
amplitude=am-pli-tude
amply=am-ply
ampule=am-pule
amputate=am-pu-tate
amputated=am-pu-tat-ed
amputating=am-pu-tat-ing
amputation=am-pu-ta-tion
amputee=am-pu-tee
amsterdam=am-ster-dam
amulet=am-u-let
amylase=am-yl-ase
anal=anal
and=and
andiron=and-i-ron
angst=angst
angstrom=ang-strom
ankh=ankh
anon=anon
ant=ant
antacid=ant-ac-id
antarctic=ant-arc-tic
antarctic=ant-arc-tic
antarctica=ant-arc-ti-ca
anteater=ant-eat-er
antler=ant-ler
antlered=ant-lered
antlike=ant-like
antlion=ant-li-on
anxious=anx-ious
anxiously=anx-ious-ly
anxiety=anx-i-e-ty
anaerobe=an-aer-obe
anaerobic=an-aer-o-bic
anaesthesia=an-aes-the-sia
anaesthesia=an-aes-the-si-a
analgesic=an-al-ge-sic
analgesia=an-al-ge-si-a
anarchic=an-ar-chic
anarchism=an-ar-chism
anarchist=an-ar-chist
anarchical=an-ar-chi-cal
anarchy=an-ar-chy
anaconda=an-a-con-da
anaconda=an-a-con-da
anadem=an-a-dem
anagram=an-a-gram
anaheim=an-a-heim
analog=an-a-log
analogue=an-a-logue
analogical=an-a-log-i-cal
analyst=an-a-lyst
analytic=an-a-lyt-ic
analytical=an-a-lyt-i-cal
analyze=an-a-lyze
analyzed=an-a-lyzed
analyzable=an-a-lyz-a-ble
analyzer=an-a-lyz-er
analyzing=an-a-lyz-ing
anapest=an-a-pest
anapestic=an-a-pes-tic
anatomic=an-a-tom-ic
anatomical=an-a-tom-i-cal
ancestor=an-ces-tor
ancestral=an-ces-tral
ancestress=an-ces-tress
ancestry=an-ces-try
anchor=an-chor
anchorage=an-chor-age
anchorage=an-chor-age
anchoress=an-cho-ress
anchorite=an-cho-rite
anchoritic=an-cho-rit-ic
anchovy=an-cho-vy
ancient=an-cient
anciently=an-cient-ly
ancillary=an-cil-lar-y
andante=an-dan-te
andantino=an-dan-ti-no
anderson=an-der-son
andorra=an-dor-ra
andrew=an-drew
androgyny=an-drog-y-ny
android=an-droid
andromeda=an-drom-e-da
andromeda=an-drom-e-da
androgen=an-dro-gen
androgenic=an-dro-gen-ic
anecdote=an-ec-dote
anecdotic=an-ec-dot-ic
anecdotist=an-ec-dot-ist
anecdotal=an-ec-do-tal
aneroid=an-er-oid
anesthetic=an-es-thet-ic
anesthesia=an-es-the-sia
anesthesia=an-es-the-si-a
aneurysm=an-eu-rysm
anechoic=an-e-cho-ic
anemometer=an-e-mom-e-ter
angel=an-gel
angel=an-gel
angelica=an-gelica
angelfish=an-gel-fish
angelic=an-gel-ic
angelic=an-gel-ic
angelica=an-gel-ic-a
angelica=an-gel-i-ca
angelica=an-gel-i-ca
angelical=an-gel-i-cal
anger=an-ger
angers=an-gers
angelo=an-ge-lo
angina=an-gi-na
anginal=an-gi-nal
anginous=an-gi-nous
angiosperm=an-gi-o-sperm
angle=an-gle
angle=an-gle
angled=an-gled
angler=an-gler
angles=an-gles
angleworm=an-gle-worm
angling=an-gling
anglican=an-gli-can
anglicanism=an-gli-can-ism
anglophobia=an-glo-pho-bi-a
angola=an-go-la
angora=an-go-ra
angora=an-go-ra
angrier=an-gri-er
angriest=an-gri-est
angrily=an-gri-ly
angry=an-gry
anguish=an-guish
anguished=an-guished
angular=an-gu-lar
angularity=an-gu-lar-i-ty
angularly=an-gu-lar-ly
anhydride=an-hy-dride
anhydrous=an-hy-drous
anile=an-ile
anise=an-ise
aniline=an-i-line
animadvert=an-i-mad-vert
animadversion=an-i-mad-ver-sion
animal=an-i-mal
animalcule=an-i-mal-cule
animalism=an-i-mal-ism
animality=an-i-mal-i-ty
animate=an-i-mate
animated=an-i-mat-ed
animater=an-i-mat-er
animating=an-i-mat-ing
animation=an-i-ma-tion
animator=an-i-ma-tor
animism=an-i-mism
animist=an-i-mist
animistic=an-i-mis-tic
animosity=an-i-mos-i-ty
animus=an-i-mus
anion=an-i-on
anionic=an-i-on-ic
aniseed=an-i-seed
anisette=an-i-sette
ankara=an-ka-ra
ankle=an-kle
anklet=an-klet
anklebone=an-kle-bone
annals=an-nals
annalist=an-nal-ist
annapolis=an-nap-o-lis
anneal=an-neal
annealer=an-neal-er
annex=an-nex
annexation=an-nex-a-tion
annelid=an-ne-lid
annihilate=an-ni-hi-late
anniversary=an-ni-ver-sa-ry
announce=an-nounce
announced=an-nounced
announcer=an-nounc-er
announcing=an-nounc-ing
annoy=an-noy
annoyance=an-noy-ance
annoying=an-noy-ing
annoyingly=an-noy-ing-ly
annotate=an-no-tate
annotated=an-no-tat-ed
annotating=an-no-tat-ing
annotation=an-no-ta-tion
annotative=an-no-ta-tive
annotator=an-no-ta-tor
annul=an-nul
annulled=an-nulled
annullable=an-nul-la-ble
annulling=an-nul-ling
annulment=an-nul-ment
annunciate=an-nun-ci-ate
annual=an-nu-al
annually=an-nu-al-ly
annuitant=an-nu-i-tant
annuity=an-nu-i-ty
annular=an-nu-lar
annularity=an-nu-lar-i-ty
annulus=an-nu-lus
anode=an-ode
anodic=an-od-ic
anodically=an-od-i-cal-ly
another=an-oth-er
anodize=an-o-dize
anodized=an-o-dized
anodizing=an-o-diz-ing
anodyne=an-o-dyne
anomie=an-o-mie
anonymity=an-o-nym-i-ty
anorectic=an-o-rec-tic
anorexia=an-o-rex-i-a
answer=an-swer
answerable=an-swer-a-ble
answerer=an-swer-er
antagonism=an-tag-o-nism
antagonist=an-tag-o-nist
antagonistic=an-tag-o-nis-tic
antagonize=an-tag-o-nize
ante=an-te
anteed=an-teed
antenna=an-ten-na
antennae=an-ten-nae
antennal=an-ten-nal
antennas=an-ten-nas
antebellum=an-te-bel-lum
antecedent=an-te-ced-ent
antechoir=an-te-choir
antedate=an-te-date
anteing=an-te-ing
antelope=an-te-lope
antenatal=an-te-na-tal
antepenult=an-te-pe-nult
anterior=an-te-ri-or
anteriorly=an-te-ri-or-ly
anteroom=an-te-room
anthem=an-them
anther=an-ther
anthology=an-thol-o-gy
anthony=an-tho-ny
anthrax=an-thrax
anthracite=an-thra-cite
anthropoid=an-thro-poid
anthropology=an-thro-pol-o-gy
anthropomorphic=an-thro-po-mor-phic
anti=an-ti
antic=an-tic
antics=an-tics
anticipate=an-tic-i-pate
anticipatory=an-tic-i-pa-to-ry
anticly=an-tic-ly
antinomy=an-tin-o-my
antiphonal=an-tiph-o-nal
antiphony=an-tiph-o-ny
antipathy=an-tip-a-thy
antipodal=an-tip-o-dal
antipodes=an-tip-o-des
antipodes=an-tip-o-des
antipodean=an-tip-o-de-an
antique=an-tique
antiqued=an-tiqued
antiquely=an-tique-ly
antiquity=an-tiq-ui-ty
antithesis=an-tith-e-sis
antibiotic=an-ti-bi-ot-ic
antibodies=an-ti-bod-ies
antibody=an-ti-bod-y
anticline=an-ti-cline
anticlimax=an-ti-cli-max
anticlinal=an-ti-cli-nal
antidote=an-ti-dote
antidotal=an-ti-dot-al
antifreeze=an-ti-freeze
antifungal=an-ti-fun-gal
antigen=an-ti-gen
antigenic=an-ti-gen-ic
antihero=an-ti-he-ro
antiknock=an-ti-knock
antilabor=an-ti-la-bor
antimatter=an-ti-mat-ter
antimony=an-ti-mo-ny
antinoise=an-ti-noise
antinovel=an-ti-nov-el
antinomian=an-ti-no-mi-an
antipasti=an-ti-pas-ti
antipasto=an-ti-pas-to
antipastos=an-ti-pas-tos
antiperspirant=an-ti-per-spi-rant
antiphon=an-ti-phon
antiphonic=an-ti-phon-ic
antipole=an-ti-pole
antipope=an-ti-pope
antiproton=an-ti-pro-ton
antiquarian=an-ti-quar-i-an
antiquary=an-ti-quar-y
antiquate=an-ti-quate
antiquated=an-ti-quat-ed
antiquing=an-ti-quing
antisepsis=an-ti-sep-sis
antiseptic=an-ti-sep-tic
antiserum=an-ti-se-rum
antiserums=an-ti-se-rums
antisocial=an-ti-so-cial
antitank=an-ti-tank
antithetic=an-ti-thet-ic
antitoxin=an-ti-tox-in
antitrust=an-ti-trust
antiunion=an-ti-un-ion
antivenin=an-ti-ven-in
antiwar=an-ti-war
antonymous=an-ton-y-mous
antonio=an-to-nio
antonio=an-to-ni-o
antonym=an-to-nym
antral=an-tral
antrum=an-trum
anvil=an-vil
any=an-y
anybodies=an-y-bod-ies
anybody=an-y-bod-y
anyhow=an-y-how
anymore=an-y-more
anyone=an-y-one
anyplace=an-y-place
anything=an-y-thing
anytime=an-y-time
anyway=an-y-way
anywhere=an-y-where
anywise=an-y-wise
ape=ape
apelike=ape-like
aphanite=aph-a-nite
aphorism=aph-o-rism
aphoristic=aph-o-ris-tic
aphrodite=aph-ro-di-te
apse=apse
apt=apt
aptly=apt-ly
aptness=apt-ness
apathetic=ap-a-thet-ic
apathy=ap-a-thy
apatite=ap-a-tite
aperture=ap-er-ture
apertural=ap-er-tur-al
aphelion=ap-he-li-on
aping=ap-ing
apical=ap-i-cal
apically=ap-i-cal-ly
apices=ap-i-ces
apostolic=ap-os-tol-ic
apogee=ap-o-gee
apogean=ap-o-ge-an
apogeic=ap-o-ge-ic
apologue=ap-o-logue
apologia=ap-o-lo-gi-a
apolune=ap-o-lune
apoplectic=ap-o-plec-tic
apoplexy=ap-o-plex-y
apothegm=ap-o-thegm
apothem=ap-o-them
appall=ap-pall
appalled=ap-palled
appalling=ap-pall-ing
appalling=ap-pal-ling
apparel=ap-par-el
appareled=ap-par-eled
apparelled=ap-par-elled
appareling=ap-par-el-ing
apparent=ap-par-ent
apparently=ap-par-ent-ly
appanage=ap-pa-nage
apparatus=ap-pa-rat-us
apparition=ap-pa-ri-tion
appeal=ap-peal
appealing=ap-peal-ing
appear=ap-pear
appearance=ap-pear-ance
appease=ap-pease
appeased=ap-peased
appeasable=ap-peas-a-ble
appeaser=ap-peas-er
appeasing=ap-peas-ing
appellant=ap-pel-lant
appellate=ap-pel-late
appellation=ap-pel-la-tion
appellee=ap-pel-lee
append=ap-pend
appendage=ap-pend-age
appendectomy=ap-pen-dec-to-my
appendix=ap-pen-dix
appendixes=ap-pen-dix-es
appendices=ap-pen-di-ces
appertain=ap-per-tain
appestat=ap-pes-tat
appetency=ap-pe-ten-cy
appetite=ap-pe-tite
appetizer=ap-pe-tiz-er
appetizing=ap-pe-tiz-ing
applaud=ap-plaud
applauder=ap-plaud-er
applause=ap-plause
apple=ap-ple
apples=ap-ples
applejack=ap-ple-jack
applesauce=ap-ple-sauce
appleton=ap-ple-ton
applied=ap-plied
appliance=ap-pli-ance
applicant=ap-pli-cant
applicable=ap-pli-ca-ble
applicably=ap-pli-ca-bly
application=ap-pli-ca-tion
applicator=ap-pli-ca-tor
applier=ap-pli-er
applique=ap-pli-que
apply=ap-ply
applying=ap-ply-ing
appoint=ap-point
appointed=ap-point-ed
appointee=ap-point-ee
appointment=ap-point-ment
appointee=ap-poin-tee
appointive=ap-poin-tive
apportion=ap-por-tion
apportionment=ap-por-tion-ment
appose=ap-pose
apposed=ap-posed
apposable=ap-pos-a-ble
apposing=ap-pos-ing
appositive=ap-pos-i-tive
apposite=ap-po-site
appositely=ap-po-site-ly
apposition=ap-po-si-tion
appraise=ap-praise
appraised=ap-praised
appraisal=ap-prais-al
appraiser=ap-prais-er
appraising=ap-prais-ing
apprentice=ap-pren-tice
appreciate=ap-pre-ci-ate
appreciable=ap-pre-ci-a-ble
apprehend=ap-pre-hend
apprehension=ap-pre-hen-sion
apprehensive=ap-pre-hen-sive
apprise=ap-prise
apprised=ap-prised
apprising=ap-pris-ing
approach=ap-proach
approve=ap-prove
approved=ap-proved
approval=ap-prov-al
approving=ap-prov-ing
approximate=ap-prox-i-mate
approbation=ap-pro-ba-tion
appropriate=ap-pro-pri-ate
appropriable=ap-pro-pri-a-ble
appropriation=ap-pro-pri-a-tion
apricot=ap-ri-cot
apropos=ap-ro-pos
aptitude=ap-ti-tude
aqua=aq-ua
aquacade=aq-ua-cade
aquamarine=aq-ua-ma-rine
aquanaut=aq-ua-naut
aquaplane=aq-ua-plane
aquaplaned=aq-ua-planed
aqueduct=aq-ue-duct
aquifer=aq-ui-fer
aquiline=aq-ui-line
arc=arc
arch=arch
arched=arched
archangel=arch-an-gel
archangel=arch-an-gel
archbishop=arch-bish-op
archdeacon=arch-dea-con
archdiocese=arch-di-o-cese
archduke=arch-duke
archenemy=arch-en-e-my
archer=arch-er
archer=arch-er
arches=arch-es
archfiend=arch-fiend
arching=arch-ing
archness=arch-ness
archway=arch-way
arcs=arcs
arctic=arc-tic
arctic=arc-tic
are=are
ark=ark
arm=arm
armed=armed
arms=arms
armchair=arm-chair
armful=arm-ful
armhole=arm-hole
arming=arm-ing
armless=arm-less
armlet=arm-let
armload=arm-load
armpit=arm-pit
armrest=arm-rest
art=art
arts=arts
artful=art-ful
artfully=art-ful-ly
artfulness=art-ful-ness
artist=art-ist
artistry=art-ist-ry
artier=art-i-er
artiest=art-i-est
artiness=art-i-ness
artless=art-less
artlessly=art-less-ly
artwork=art-work
arty=art-y
arabesque=ar-a-besque
arabic=ar-a-bic
arable=ar-a-ble
arbalest=ar-ba-lest
arbiter=ar-bi-ter
arbitrage=ar-bi-trage
arbitrager=ar-bi-trag-er
arbitrary=ar-bi-trar-y
arbitrate=ar-bi-trate
arbitrated=ar-bi-trat-ed
arbitrator=ar-bi-tra-tor
arbor=ar-bor
arboreal=ar-bor-e-al
arborvitae=ar-bor-vi-tae
arboreal=ar-bo-re-al
arboretum=ar-bo-re-tum
arbutus=ar-bu-tus
arbutuses=ar-bu-tus-es
arcade=ar-cade
arcane=ar-cane
arcadia=ar-ca-di-a
archaic=ar-cha-ic
archaism=ar-cha-ism
archaist=ar-cha-ist
archaistic=ar-cha-is-tic
archer=ar-cher
archery=ar-cher-y
archetype=ar-che-type
archetypal=ar-che-typ-al
archive=ar-chive
archives=ar-chives
archipelago=ar-chi-pel-a-go
architect=ar-chi-tect
architectonic=ar-chi-tec-ton-ic
architecture=ar-chi-tec-ture
architectural=ar-chi-tec-tur-al
architrave=ar-chi-trave
archival=ar-chi-val
archivist=ar-chi-vist
archon=ar-chon
archonship=ar-chon-ship
arcuate=ar-cu-ate
ardent=ar-dent
ardently=ar-dent-ly
ardency=ar-den-cy
ardor=ar-dor
arduous=ar-du-ous
arduously=ar-du-ous-ly
ares=ar-es
area=ar-e-a
areal=ar-e-al
areaway=ar-e-a-way
argent=ar-gent
argentite=ar-gen-tite
argentina=ar-gen-ti-na
argillaceous=ar-gil-la-ceous
argon=ar-gon
argot=ar-got
argosy=ar-go-sy
argue=ar-gue
argued=ar-gued
arguable=ar-gu-a-ble
arguing=ar-gu-ing
argument=ar-gu-ment
argumentation=ar-gu-men-ta-tion
argumentative=ar-gu-men-ta-tive
argyle=ar-gyle
argyle=ar-gyle
arid=ar-id
aridly=ar-id-ly
aristocracy=ar-is-toc-ra-cy
aristotle=ar-is-tot-le
aristotelian=ar-is-to-te-lian
aristotelian=ar-is-to-te-li-an
aristotle=ar-is-to-tle
arizona=ar-i-zo-na
arkansas=ar-kan-sas
arlington=ar-ling-ton
armada=ar-ma-da
armada=ar-ma-da
armadillo=ar-ma-dil-lo
armageddon=ar-ma-ged-don
armament=ar-ma-ment
armature=ar-ma-ture
armenia=ar-me-ni-a
armenian=ar-me-ni-an
armistice=ar-mi-stice
armor=ar-mor
armored=ar-mored
armorer=ar-mor-er
armories=ar-mor-ies
armory=ar-mor-y
armour=ar-mour
armorial=ar-mo-ri-al
army=ar-my
armyworm=ar-my-worm
arnica=ar-ni-ca
arnold=ar-nold
aromatic=ar-o-mat-ic
arpeggio=ar-peg-gi-o
arpeggios=ar-peg-gi-os
arrack=ar-rack
arraign=ar-raign
arrange=ar-range
arranged=ar-ranged
arrangement=ar-range-ment
arranger=ar-rang-er
arranging=ar-rang-ing
arrant=ar-rant
arras=ar-ras
arras=ar-ras
array=ar-ray
arrear=ar-rear
arrears=ar-rears
arrest=ar-rest
arrester=ar-rest-er
arresting=ar-rest-ing
arrhythmia=ar-rhyth-mi-a
arrive=ar-rive
arrived=ar-rived
arriver=ar-riv-er
arriving=ar-riv-ing
arrival=ar-ri-val
arrow=ar-row
arrows=ar-rows
arrowhead=ar-row-head
arrowroot=ar-row-root
arroyo=ar-roy-o
arrogance=ar-ro-gance
arrogant=ar-ro-gant
arrogantly=ar-ro-gant-ly
arrogate=ar-ro-gate
arrogated=ar-ro-gat-ed
arrogating=ar-ro-gat-ing
arrogation=ar-ro-ga-tion
arsenical=ar-sen-i-cal
arsenal=ar-se-nal
arsenate=ar-se-nate
arsenic=ar-se-nic
arsenious=ar-se-ni-ous
arson=ar-son
arsonist=ar-son-ist
arteries=ar-ter-ies
artery=ar-ter-y
artemis=ar-te-mis
arterial=ar-te-ri-al
arteriole=ar-te-ri-ole
arteriosclerosis=ar-te-ri-o-scle-ro-sis
artesian=ar-te-sian
arthritic=ar-thrit-ic
arthritis=ar-thri-tis
arthropod=ar-thro-pod
arthur=ar-thur
articular=ar-tic-u-lar
articulate=ar-tic-u-late
artificer=ar-tif-i-cer
artillery=ar-til-ler-y
artiste=ar-tiste
artistic=ar-tis-tic
artichoke=ar-ti-choke
article=ar-ti-cle
artifact=ar-ti-fact
artifice=ar-ti-fice
artificial=ar-ti-fi-cial
artisan=ar-ti-san
arty=ar-ty
arum=ar-um
ascetic=ascetic
ash=ash
asheville=ashe-ville
ashen=ash-en
ashes=ash-es
ashes=ash-es
ashier=ash-i-er
ashiest=ash-i-est
ashlar=ash-lar
ashram=ash-ram
ashtray=ash-tray
ashy=ash-y
ask=ask
asker=ask-er
asp=asp
aspish=asp-ish
ass=ass
asslike=ass-like
asthma=asth-ma
asthmatic=asth-mat-ic
asafetida=as-a-fet-i-da
asbestos=as-bes-tos
ascend=as-cend
ascendant=as-cend-ant
ascendancy=as-cend-an-cy
ascending=as-cend-ing
ascent=as-cent
ascension=as-cen-sion
ascension=as-cen-sion
ascertain=as-cer-tain
ascetic=as-cet-ic
asceticism=as-cet-i-cism
ascot=as-cot
ascot=as-cot
ascribe=as-cribe
ascribed=as-cribed
ascribing=as-crib-ing
ascription=as-crip-tion
asinine=as-i-nine
asininely=as-i-nine-ly
asininity=as-i-nin-i-ty
asparagus=as-par-a-gus
aspect=as-pect
aspen=as-pen
aspen=as-pen
asperse=as-perse
aspersed=as-persed
aspersing=as-pers-ing
asperity=as-per-i-ty
aspersion=as-per-sion
asphalt=as-phalt
asphaltic=as-phal-tic
asphodel=as-pho-del
asphyxia=as-phyx-ia
asphyxia=as-phyx-i-a
asphyxiate=as-phyx-i-ate
aspic=as-pic
aspire=as-pire
aspired=as-pired
aspirant=as-pir-ant
aspiring=as-pir-ing
aspiringly=as-pir-ing-ly
aspidistra=as-pi-dis-tra
aspirate=as-pi-rate
aspirated=as-pi-rat-ed
aspirating=as-pi-rat-ing
aspiration=as-pi-ra-tion
aspirator=as-pi-ra-tor
aspirin=as-pi-rin
assail=as-sail
assailant=as-sail-ant
assailable=as-sail-a-ble
assassin=as-sas-sin
assassin=as-sas-sin
assassinate=as-sas-si-nate
assault=as-sault
assaulter=as-sault-er
assay=as-say
assayer=as-say-er
assemblage=as-sem-blage
assemble=as-sem-ble
assembled=as-sem-bled
assembler=as-sem-bler
assembly=as-sem-bly
assembly=as-sem-bly
assent=as-sent
assert=as-sert
asserted=as-sert-ed
asserter=as-sert-er
assertion=as-ser-tion
assertive=as-ser-tive
assertor=as-ser-tor
asses=as-ses
assess=as-sess
assessable=as-sess-a-ble
assessment=as-sess-ment
assessor=as-ses-sor
asset=as-set
assets=as-sets
asseverate=as-sev-er-ate
assiduous=as-sid-u-ous
assign=as-sign
assignable=as-sign-a-ble
assignee=as-sign-ee
assigner=as-sign-er
assignment=as-sign-ment
assignor=as-sign-or
assignation=as-sig-na-tion
assimilate=as-sim-i-late
assimilable=as-sim-i-la-ble
assist=as-sist
assister=as-sist-er
assistance=as-sis-tance
assistant=as-sis-tant
assistor=as-sis-tor
assize=as-size
assizes=as-siz-es
assiduity=as-si-du-i-ty
assort=as-sort
assorted=as-sort-ed
assortment=as-sort-ment
associate=as-so-ci-ate
associated=as-so-ci-at-ed
associable=as-so-ci-a-ble
associative=as-so-ci-a-tive
assonance=as-so-nance
assonant=as-so-nant
assuage=as-suage
assuaged=as-suaged
assuaging=as-suag-ing
assuasive=as-sua-sive
assume=as-sume
assumed=as-sumed
assumption=as-sump-tion
assumption=as-sump-tion
assumptive=as-sump-tive
assumable=as-sum-a-ble
assumably=as-sum-a-bly
assumedly=as-sum-ed-ly
assuming=as-sum-ing
assure=as-sure
assured=as-sured
assurance=as-sur-ance
assuredly=as-sur-ed-ly
assuring=as-sur-ing
assyria=as-syr-i-a
astatine=as-ta-tine
aster=as-ter
asterisk=as-ter-isk
asterism=as-ter-ism
asteroid=as-ter-oid
asteroidal=as-ter-oi-dal
astigmatic=as-tig-mat-ic
astonish=as-ton-ish
astound=as-tound
astounding=as-tound-ing
astral=as-tral
astrakhan=as-tra-khan
astrakhan=as-tra-khan
astringent=as-trin-gent
astrologer=as-trol-o-ger
astrology=as-trol-o-gy
astronomer=as-tron-o-mer
astronomy=as-tron-o-my
astrolabe=as-tro-labe
astronaut=as-tro-naut
astronauts=as-tro-nauts
astronautic=as-tro-nau-tic
astronomic=as-tro-nom-ic
astrophysics=as-tro-phys-ics
astrophysical=as-tro-phys-i-cal
astute=as-tute
astutely=as-tute-ly
astuteness=as-tute-ness
asymptote=as-ymp-tote
asymptotic=as-ymp-tot-ic
ate=ate
athens=ath-ens
athenaeum=ath-e-nae-um
athenaeum=ath-e-nae-um
athlete=ath-lete
athletic=ath-let-ic
athletics=ath-let-ics
attn=attn
atavism=at-a-vism
atavist=at-a-vist
atavistic=at-a-vis-tic
atelier=at-el-ier
ateliers=at-el-iers
atlanta=at-lan-ta
atlantic=at-lan-tic
atlantis=at-lan-tis
atlas=at-las
atlas=at-las
atlases=at-las-es
atmosphere=at-mos-phere
atmospheric=at-mos-pher-ic
atoll=at-oll
atom=at-om
atomism=at-om-ism
atomist=at-om-ist
atomize=at-om-ize
atomized=at-om-ized
atomizer=at-om-iz-er
atomizing=at-om-iz-ing
atrophied=at-ro-phied
atrophy=at-ro-phy
atrophying=at-ro-phy-ing
atropine=at-ro-pine
attach=at-tach
attached=at-tached
attachable=at-tach-a-ble
attachment=at-tach-ment
attack=at-tack
attacker=at-tack-er
attain=at-tain
attaint=at-taint
attainable=at-tain-a-ble
attainder=at-tain-der
attainment=at-tain-ment
attar=at-tar
attach=at-ta-ch
attempt=at-tempt
attempter=at-tempt-er
attend=at-tend
attendance=at-tend-ance
attendant=at-tend-ant
attender=at-tend-er
attending=at-tend-ing
attention=at-ten-tion
attentive=at-ten-tive
attenuate=at-ten-u-ate
attenuated=at-ten-u-at-ed
attest=at-test
attested=at-test-ed
attestation=at-tes-ta-tion
attic=at-tic
attic=at-tic
attire=at-tire
attired=at-tired
attiring=at-tir-ing
attitude=at-ti-tude
attorney=at-tor-ney
attract=at-tract
attractant=at-tract-ant
attraction=at-trac-tion
attractive=at-trac-tive
attribute=at-trib-ute
attributed=at-trib-ut-ed
attributive=at-trib-u-tive
attribution=at-tri-bu-tion
attrition=at-tri-tion
attune=at-tune
attuned=at-tuned
attuning=at-tun-ing
auction=auc-tion
auctioneer=auc-tion-eer
auctorial=auc-to-ri-al
aught=aught
augment=aug-ment
augmented=aug-ment-ed
augmenter=aug-ment-er
augmentation=aug-men-ta-tion
auk=auk
auld=auld
aunt=aunt
auntie=aunt-ie
auscultate=aus-cul-tate
auspice=aus-pice
auspices=aus-pic-es
auspices=aus-pi-ces
auspicious=aus-pi-cious
austere=aus-tere
austerely=aus-tere-ly
austerity=aus-ter-i-ty
austin=aus-tin
austral=aus-tral
australia=aus-tral-ia
australia=aus-tral-i-a
austria=aus-tri-a
authoress=auth-or-ess
auto=auto
auxiliary=aux-il-ia-ry
auxin=aux-in
auburn=au-burn
auburn=au-burn
audacity=au-dac-i-ty
audacious=au-da-cious
audit=au-dit
audibility=au-di-bil-i-ty
audible=au-di-ble
audibly=au-di-bly
audience=au-di-ence
audio=au-di-o
audiology=au-di-ol-o-gy
audiometer=au-di-om-e-ter
audiophile=au-di-o-phile
audiovisual=au-di-o-vis-u-al
audition=au-di-tion
auditor=au-di-tor
auditoria=au-di-to-ri-a
auditorium=au-di-to-ri-um
auditory=au-di-to-ry
auger=au-ger
augean=au-ge-an
augur=au-gur
august=au-gust
august=au-gust
augustness=au-gust-ness
augusta=au-gus-ta
augustan=au-gus-tan
augury=au-gu-ry
aura=au-ra
aura=au-ra
aural=au-ral
aural=au-ral
aurally=au-ral-ly
aurar=au-rar
auras=au-ras
aureate=au-re-ate
aureately=au-re-ate-ly
aureole=au-re-ole
auricular=au-ric-u-lar
auriferous=au-rif-er-ous
auricle=au-ri-cle
auricled=au-ri-cled
aurora=au-ro-ra
aurora=au-ro-ra
auroral=au-ro-ral
authentic=au-then-tic
authenticate=au-then-ti-cate
author=au-thor
authors=au-thors
authoress=au-thor-ess
authorize=au-thor-ize
authorized=au-thor-ized
authoritarian=au-thor-i-tar-i-an
authoritative=au-thor-i-ta-tive
authority=au-thor-i-ty
authorship=au-thor-ship
autism=au-tism
autistic=au-tis-tic
auto=au-to
autocracy=au-toc-ra-cy
automata=au-tom-a-ta
automatism=au-tom-a-tism
automatize=au-tom-a-tize
automaton=au-tom-a-ton
autonomous=au-ton-o-mous
autonomy=au-ton-o-my
autopsy=au-top-sy
autobahn=au-to-bahn
autobahns=au-to-bahns
autobiography=au-to-bi-og-ra-phy
autoclave=au-to-clave
autocrat=au-to-crat
autocratic=au-to-crat-ic
autodidact=au-to-di-dact
autogiro=au-to-gi-ro
autograph=au-to-graph
automat=au-to-mat
automate=au-to-mate
automated=au-to-mat-ed
automatic=au-to-mat-ic
automating=au-to-mat-ing
automation=au-to-ma-tion
automobile=au-to-mo-bile
automotive=au-to-mo-tive
autonomic=au-to-nom-ic
autopilot=au-to-pi-lot
autostrada=au-to-stra-da
autumn=au-tumn
autumnal=au-tum-nal
ave=ave
avalanche=av-a-lanche
avarice=av-a-rice
avaricious=av-a-ri-cious
avatar=av-a-tar
average=av-er-age
averaged=av-er-aged
averaging=av-er-ag-ing
avenue=av-e-nue
avid=av-id
avidly=av-id-ly
avocado=av-o-ca-do
avocation=av-o-ca-tion
avocet=av-o-cet
awe=awe
awed=awed
awesome=awe-some
awesomely=awe-some-ly
awkward=awk-ward
awkwardly=awk-ward-ly
awl=awl
awn=awn
awning=awn-ing
awful=aw-ful
awfully=aw-ful-ly
awfulness=aw-ful-ness
awing=aw-ing
axes=ax-es
axing=ax-ing
axis=ax-is
axis=ax-is
axial=ax-i-al
axially=ax-i-al-ly
axiom=ax-i-om
axiomatic=ax-i-o-mat-ic
axle=ax-le
axletree=ax-le-tree
axon=ax-on
aye=aye
azimuth=az-i-muth
azimuthal=az-i-muth-al
aztec=az-tec
aztecan=az-tec-an
azure=az-ure
aback=a-back
abaft=a-baft
abandon=a-ban-don
abandoned=a-ban-doned
abandoner=a-ban-don-er
abase=a-base
abased=a-based
abasement=a-base-ment
abash=a-bash
abashedly=a-bash-ed-ly
abashment=a-bash-ment
abaser=a-bas-er
abasing=a-bas-ing
abate=a-bate
abatement=a-bate-ment
abatable=a-bat-a-ble
abated=a-bat-ed
abater=a-bat-er
abating=a-bat-ing
abeam=a-beam
abed=a-bed
abet=a-bet
abetment=a-bet-ment
abetted=a-bet-ted
abetter=a-bet-ter
abetting=a-bet-ting
abettor=a-bet-tor
abeyance=a-bey-ance
abide=a-bide
abidance=a-bid-ance
abided=a-bid-ed
abiding=a-bid-ing
abidingly=a-bid-ing-ly
ability=a-bil-i-ty
ablaze=a-blaze
able=a-ble
abler=a-bler
ablest=a-blest
abloom=a-bloom
ably=a-bly
aboard=a-board
abode=a-bode
abolish=a-bol-ish
abominate=a-bom-i-nate
abominated=a-bom-i-nat-ed
abominable=a-bom-i-na-ble
abominably=a-bom-i-na-bly
abominator=a-bom-i-na-tor
aborning=a-born-ing
abort=a-bort
abortion=a-bor-tion
abortional=a-bor-tion-al
abortive=a-bor-tive
abortively=a-bor-tive-ly
abound=a-bound
about=a-bout
above=a-bove
aboveboard=a-bove-board
abrade=a-brade
abraded=a-brad-ed
abrader=a-brad-er
abrading=a-brad-ing
abrasion=a-bra-sion
abrasive=a-bra-sive
abreast=a-breast
abridge=a-bridge
abridged=a-bridged
abridger=a-bridg-er
abridging=a-bridg-ing
abridgment=a-bridg-ment
abroad=a-broad
abundance=a-bun-dance
abundant=a-bun-dant
abundantly=a-bun-dant-ly
abuse=a-buse
abused=a-bused
abusing=a-bus-ing
abut=a-but
abutment=a-but-ment
abuttal=a-but-tal
abuttals=a-but-tals
abutted=a-but-ted
abutter=a-but-ter
abutting=a-but-ting
abusive=a-bu-sive
abusively=a-bu-sive-ly
abyss=a-byss
abyssal=a-byss-al
abysmal=a-bys-mal
abysmally=a-bys-mal-ly
abyssal=a-bys-sal
academy=a-cad-e-my
academy=a-cad-e-my
acanthi=a-can-thi
acanthus=a-can-thus
acanthuses=a-can-thus-es
acacia=a-ca-cia
acerb=a-cerb
acerbic=a-cer-bic
acerbity=a-cer-bi-ty
acetified=a-cet-i-fied
acetify=a-cet-i-fy
acetifying=a-cet-i-fy-ing
acetylene=a-cet-y-lene
acetic=a-ce-tic
achene=a-chene
achenial=a-che-ni-al
achieve=a-chieve
achieved=a-chieved
achievable=a-chiev-a-ble
achiever=a-chiev-er
achieving=a-chiev-ing
achilles=a-chil-les
acidic=a-cid-ic
acidified=a-cid-i-fied
acidifier=a-cid-i-fi-er
acidify=a-cid-i-fy
acidifying=a-cid-i-fy-ing
acidity=a-cid-i-ty
acidulate=a-cid-u-late
acidulated=a-cid-u-lat-ed
acidulous=a-cid-u-lous
acorn=a-corn
acoustic=a-cous-tic
acoustics=a-cous-tics
acoustical=a-cous-ti-cal
acre=a-cre
acre=a-cre
acreage=a-cre-age
acridity=a-crid-i-ty
acropolis=a-crop-o-lis
acropolis=a-crop-o-lis
across=a-cross
acrostic=a-cros-tic
acrylic=a-cryl-ic
acute=a-cute
acutely=a-cute-ly
acuteness=a-cute-ness
acuity=a-cu-i-ty
acumen=a-cu-men
acres=a-c-res
adapt=a-dapt
adaptable=a-dapt-a-ble
adapter=a-dapt-er
adaptive=a-dap-tive
adaptively=a-dap-tive-ly
adagio=a-da-gio
adagio=a-da-gi-o
adept=a-dept
adeptly=a-dept-ly
adeptness=a-dept-ness
adieu=a-dieu
adieus=a-dieus
adieux=a-dieux
adios=a-di-os
ado=a-do
adopt=a-dopt
adopted=a-dopt-ed
adopter=a-dopt-er
adoption=a-dop-tion
adoptive=a-dop-tive
adoptively=a-dop-tive-ly
adore=a-dore
adored=a-dored
adorn=a-dorn
adorner=a-dorn-er
adornment=a-dorn-ment
adorable=a-dor-a-ble
adorably=a-dor-a-bly
adorer=a-dor-er
adoring=a-dor-ing
adobe=a-do-be
adrenaline=a-dren-a-line
adrift=a-drift
adroit=a-droit
adroitly=a-droit-ly
adroitness=a-droit-ness
adult=a-dult
adulthood=a-dult-hood
adultness=a-dult-ness
adulterant=a-dul-ter-ant
adulterate=a-dul-ter-ate
adulterer=a-dul-ter-er
adulteress=a-dul-ter-ess
adulteries=a-dul-ter-ies
adulterous=a-dul-ter-ous
adultery=a-dul-ter-y
afar=a-far
afield=a-field
afire=a-fire
aficionado=a-fi-cio-na-do
aflame=a-flame
afloat=a-float
aflutter=a-flut-ter
afoot=a-foot
aforesaid=a-fore-said
afoul=a-foul
afraid=a-fraid
afresh=a-fresh
again=a-gain
against=a-gainst
agape=a-gape
agar=a-gar
agar=a-gar
agape=a-ga-pe
agape=a-ga-pe
agave=a-ga-ve
agave=a-ga-ve
aged=a-ged
agent=a-gent
agency=a-gen-cy
agenda=a-gen-da
aghast=a-ghast
agility=a-gil-i-ty
agleam=a-gleam
agley=a-gley
aglitter=a-glit-ter
aglow=a-glow
ago=a-go
agog=a-gog
agrarian=a-grar-i-an
agree=a-gree
agreed=a-greed
agreeable=a-gree-a-ble
agreeably=a-gree-a-bly
agreeing=a-gree-ing
agreement=a-gree-ment
agreement=a-gree-ment
agronomist=a-gron-o-mist
agronomy=a-gron-o-my
aground=a-ground
ague=a-gue
aha=a-ha
ahead=a-head
ahem=a-hem
ahoy=a-hoy
ain=a-in
air=a-ir
ajar=a-jar
akimbo=a-kim-bo
akin=a-kin
alacrity=a-lac-ri-ty
alai=a-lai
alar=a-lar
alarm=a-larm
alarmingly=a-larm-ing-ly
alarmism=a-larm-ism
alarmist=a-larm-ist
alas=a-las
alaska=a-las-ka
alee=a-lee
alembic=a-lem-bic
alert=a-lert
alertly=a-lert-ly
alertness=a-lert-ness
alexia=a-lex-i-a
aleatory=a-le-a-to-ry
alight=a-light
alighted=a-light-ed
alighting=a-light-ing
align=a-lign
alignment=a-lign-ment
alike=a-like
alikeness=a-like-ness
alit=a-lit
alive=a-live
aliveness=a-live-ness
alizarin=a-liz-a-rin
alias=a-li-as
aliases=a-li-as-es
aloft=a-loft
alone=a-lone
along=a-long
alongshore=a-long-shore
alongside=a-long-side
aloof=a-loof
aloofly=a-loof-ly
aloofness=a-loof-ness
aloud=a-loud
aloha=a-lo-ha
aloha=a-lo-ha
alumna=a-lum-na
alumnus=a-lum-nus
alumina=a-lu-mi-na
aluminize=a-lu-mi-nize
aluminized=a-lu-mi-nized
aluminum=a-lu-mi-num
am=a-m
amah=a-mah
amain=a-main
amalgam=a-mal-gam
amalgamate=a-mal-gam-ate
amanuensis=a-man-u-en-sis
amass=a-mass
amassment=a-mass-ment
amaze=a-maze
amazed=a-mazed
amazement=a-maze-ment
amazedly=a-maz-ed-ly
amazing=a-maz-ing
amazingly=a-maz-ing-ly
ameliorate=a-mel-io-rate
amen=a-men
amen=a-men
amend=a-mend
amends=a-mends
amendable=a-mend-a-ble
amendment=a-mend-ment
amenity=a-men-i-ty
amerce=a-merce
amerced=a-merced
amercement=a-merce-ment
amercing=a-merc-ing
america=a-mer-i-ca
american=a-mer-i-can
ameliorate=a-me-lio-rate
amenable=a-me-na-ble
amenably=a-me-na-bly
amid=a-mid
amidst=a-midst
amidic=a-mid-ic
amidships=a-mid-ships
amiss=a-miss
amiability=a-mi-a-bil-i-ty
amiable=a-mi-a-ble
amiably=a-mi-a-bly
amigo=a-mi-go
amino=a-mi-no
amoeba=a-moe-ba
amoebic=a-moe-bic
amoeboid=a-moe-boid
among=a-mong
amongst=a-mongst
amoral=a-mor-al
amorally=a-mor-al-ly
amorphous=a-mor-phous
amortize=a-mor-tize
amount=a-mount
amour=a-mour
amorality=a-mo-ral-i-ty
amuck=a-muck
amuse=a-muse
amused=a-mused
amusement=a-muse-ment
amusing=a-mus-ing
amusingly=a-mus-ing-ly
anachronism=a-nach-ro-nism
anachronistic=a-nach-ro-nis-tic
anal=a-nal
anally=a-nal-ly
analogous=a-nal-o-gous
analogy=a-nal-o-gy
analysand=a-nal-y-sand
analysis=a-nal-y-sis
anastomotic=a-nas-to-mot-ic
anastomosis=a-nas-to-mo-sis
anathema=a-nath-e-ma
anatomist=a-nat-o-mist
anatomize=a-nat-o-mize
anatomized=a-nat-o-mized
anatomy=a-nat-o-my
anemone=a-nem-o-ne
anent=a-nent
anew=a-new
anemic=a-ne-mic
anemia=a-ne-mi-a
anility=a-nil-i-ty
anoint=a-noint
anointer=a-noint-er
anointment=a-noint-ment
anomalous=a-nom-a-lous
anomaly=a-nom-a-ly
anon=a-non
anonymous=a-non-y-mous
anopheles=a-noph-e-les
anus=a-nus
anuses=a-nus-es
aorta=a-or-ta
aortic=a-or-tic
aoudad=a-ou-dad
apace=a-pace
apache=a-pache
apache=a-pach-e
apart=a-part
apartheid=a-part-heid
apartment=a-part-ment
apeak=a-peak
apercu=a-per-cu
apex=a-pex
apexes=a-pex-es
aphasia=a-pha-sia
aphasic=a-pha-sic
aphasia=a-pha-si-a
aphasiac=a-pha-si-ac
aphelia=a-phe-li-a
aphelian=a-phe-li-an
aphelion=a-phe-li-on
aphid=a-phid
aphotic=a-pho-tic
apiece=a-piece
apiaries=a-pi-ar-ies
apiary=a-pi-ar-y
apiarist=a-pi-a-rist
apices=a-pi-ces
aplenty=a-plen-ty
aplomb=a-plomb
apocalypse=a-poc-a-lypse
apocalypse=a-poc-a-lypse
apocalyptic=a-poc-a-lyp-tic
apocrypha=a-poc-ry-pha
apocrypha=a-poc-ry-pha
apocryphal=a-poc-ry-phal
apollo=a-pol-lo
apollo=a-pol-lo
apologetic=a-pol-o-get-ic
apologist=a-pol-o-gist
apologize=a-pol-o-gize
apologized=a-pol-o-gized
apologizer=a-pol-o-giz-er
apology=a-pol-o-gy
aport=a-port
apostate=a-pos-tate
apostasy=a-pos-ta-sy
apostatize=a-pos-ta-tize
apostle=a-pos-tle
apostrophe=a-pos-tro-phe
apostrophize=a-pos-tro-phize
apothecary=a-poth-e-car-y
apotheosis=a-poth-e-o-sis
apolitical=a-po-lit-i-cal
april=a-pril
apricot=a-pri-cot
apron=a-pron
apronlike=a-pron-like
aquaria=a-quar-i-a
aquarium=a-quar-i-um
aquariums=a-quar-i-ums
aquarius=a-quar-i-us
aquatic=a-quat-ic
aquatics=a-quat-ics
aqueous=a-que-ous
aqueously=a-que-ous-ly
arachnid=a-rach-nid
arabia=a-ra-bi-a
arena=a-re-na
aridity=a-rid-i-ty
aright=a-right
arise=a-rise
arisen=a-ris-en
aristocrat=a-ris-to-crat
aristocratic=a-ris-to-crat-ic
arithmetic=a-rith-me-tic
aria=a-ri-a
aria=a-ri-a
arose=a-rose
around=a-round
arouse=a-rouse
aroused=a-roused
arousal=a-rous-al
arousing=a-rous-ing
aroma=a-ro-ma
ascribable=a-scrib-a-ble
aseptic=a-sep-tic
asexual=a-sex-u-al
asexuality=a-sex-u-al-i-ty
asexually=a-sex-u-al-ly
ashamed=a-shamed
ashamedly=a-sham-ed-ly
ashore=a-shore
aside=a-side
asiatic=a-si-at-ic
askance=a-skance
askew=a-skew
aslant=a-slant
asleep=a-sleep
asocial=a-so-cial
astern=a-stern
astigmatism=a-stig-ma-tism
astir=a-stir
astonish=a-ston-ish
astound=a-stound
astraddle=a-strad-dle
astray=a-stray
astride=a-stride
asunder=a-sun-der
aswarm=a-swarm
asymmetric=a-sym-met-ric
asymmetry=a-sym-me-try
asylum=a-sy-lum
ate=a-te
atheism=a-the-ism
atheist=a-the-ist
atheistic=a-the-is-tic
athena=a-the-na
athirst=a-thirst
athwart=a-thwart
atilt=a-tilt
atomic=a-tom-ic
atomically=a-tom-i-cal-ly
atone=a-tone
atoned=a-toned
atoneable=a-tone-a-ble
atonement=a-tone-ment
atonal=a-ton-al
atonally=a-ton-al-ly
atonable=a-ton-a-ble
atoner=a-ton-er
atoning=a-ton-ing
atoningly=a-ton-ing-ly
atop=a-top
atonality=a-to-nal-i-ty
atria=a-tri-a
atrial=a-tri-al
atrium=a-tri-um
atrocity=a-troc-i-ty
atrophic=a-troph-ic
atrocious=a-tro-cious
atwitter=a-twit-ter
atypical=a-typ-i-cal
atypically=a-typ-i-cal-ly
avail=a-vail
available=a-vail-a-ble
avast=a-vast
avaunt=a-vaunt
ave=a-ve
ave=a-ve
avenge=a-venge
avenged=a-venged
avenger=a-veng-er
avenging=a-veng-ing
avengingly=a-veng-ing-ly
aver=a-ver
averred=a-verred
averse=a-verse
avert=a-vert
averment=a-ver-ment
averring=a-ver-ring
aversion=a-ver-sion
aviary=a-viar-y
avidity=a-vid-i-ty
avion=a-vion
avis=a-vis
avian=a-vi-an
aviaries=a-vi-ar-ies
aviary=a-vi-ar-y
aviate=a-vi-ate
aviation=a-vi-a-tion
aviator=a-vi-a-tor
aviatrix=a-vi-a-trix
avionics=a-vi-on-ics
avoid=a-void
avoidance=a-void-ance
avoidable=a-void-a-ble
avoidably=a-void-a-bly
avoider=a-void-er
avouch=a-vouch
avow=a-vow
avowed=a-vowed
avowal=a-vow-al
avowedly=a-vow-ed-ly
avogadro=a-vo-ga-dro
avuncular=a-vun-cu-lar
await=a-wait
awake=a-wake
awaked=a-waked
awaken=a-wak-en
awakening=a-wak-en-ing
awaking=a-wak-ing
award=a-ward
aware=a-ware
awareness=a-ware-ness
awash=a-wash
away=a-way
aweigh=a-weigh
awhile=a-while
awhirl=a-whirl
awoke=a-woke
awry=a-wry
ayah=a-yah
azalea=a-zal-ea
baa=baa
baa=baa
baas=baas
baaing=baa-ing
babe=babe
babe=babe
babel=babel
babbitt=bab-bitt
babbitt=bab-bitt
babble=bab-ble
babbler=bab-bler
babbling=bab-bling
babylon=bab-y-lon
babylonian=bab-y-lo-ni-an
bachelor=bach-e-lor
back=back
backed=backed
backs=backs
backache=back-ache
backbit=back-bit
backbite=back-bite
backbiter=back-bit-er
backbiting=back-bit-ing
backbitten=back-bit-ten
backboard=back-board
backbone=back-bone
backdate=back-date
backdrop=back-drop
backer=back-er
backfield=back-field
backfire=back-fire
backfired=back-fired
backfiring=back-fir-ing
backgammon=back-gam-mon
background=back-ground
backhand=back-hand
backhanded=back-hand-ed
backing=back-ing
backlash=back-lash
backless=back-less
backlog=back-log
backlogged=back-logged
backpack=back-pack
backpacker=back-pack-er
backrest=back-rest
backside=back-side
backslide=back-slide
backslider=back-slid-er
backspace=back-space
backspaced=back-spaced
backspin=back-spin
backstage=back-stage
backstairs=back-stairs
backstop=back-stop
backstretch=back-stretch
backstroke=back-stroke
backswept=back-swept
backtrack=back-track
backup=back-up
backward=back-ward
backwards=back-wards
backwardly=back-ward-ly
backwash=back-wash
backwater=back-wa-ter
backwood=back-wood
backwoods=back-woods
backyard=back-yard
baccalaureate=bac-ca-lau-re-ate
baccarat=bac-ca-rat
bacchanal=bac-cha-nal
bacchus=bac-chus
bacillary=bac-il-lar-y
bacteria=bac-te-ri-a
bacterial=bac-te-ri-al
bacterium=bac-te-ri-um
bad=bad
bade=bade
badge=badge
badger=badg-er
badinage=bad-i-nage
badinaged=bad-i-naged
badlands=bad-lands
badly=bad-ly
badman=bad-man
badminton=bad-min-ton
badness=bad-ness
baffle=baf-fle
baffler=baf-fler
bafflement=baf-fle-ment
baffling=baf-fling
bag=bag
baghdad=bagh-dad
bags=bags
bagatelle=bag-a-telle
baggage=bag-gage
bagging=bag-ging
baggier=bag-gi-er
baggiest=bag-gi-est
baggily=bag-gi-ly
bagginess=bag-gi-ness
baggy=bag-gy
bagman=bag-man
bagpipe=bag-pipe
bagpipes=bag-pipes
bagpiper=bag-pip-er
bah=bah
baht=baht
bail=bail
bailsman=bails-man
bailable=bail-a-ble
bailer=bail-er
bailiff=bail-iff
bailiwick=bail-i-wick
bailment=bail-ment
bailor=bail-or
bailout=bail-out
bairn=bairn
bait=bait
baiter=bait-er
baize=baize
bailey=bai-ley
bailey=bai-ley
bake=bake
bakeshop=bake-shop
baker=bak-er
baker=bak-er
bakersfield=bak-ers-field
bakeries=bak-er-ies
bakery=bak-er-y
baking=bak-ing
baklava=bak-la-va
baksheesh=bak-sheesh
bald=bald
baldly=bald-ly
baldness=bald-ness
baldwin=bald-win
bale=bale
baleful=bale-ful
balefully=bale-ful-ly
balk=balk
balker=balk-er
balkier=balk-i-er
balkiest=balk-i-est
balkiness=balk-i-ness
balky=balk-y
ball=ball
ball=ball
balls=balls
ballplayer=ball-play-er
ballpoint=ball-point
ballroom=ball-room
balm=balm
balmier=balm-i-er
balmiest=balm-i-est
balmily=balm-i-ly
balminess=balm-i-ness
balmy=balm-y
balance=bal-ance
balance=bal-ance
balanced=bal-anced
balancing=bal-anc-ing
balalaika=bal-a-lai-ka
balboa=bal-bo-a
balboa=bal-bo-a
balbriggan=bal-brig-gan
balcony=bal-co-ny
baldachin=bal-da-chin
balder=bal-der
balderdash=bal-der-dash
baldric=bal-dric
baler=bal-er
baling=bal-ing
balkan=bal-kan
ballad=bal-lad
balladeer=bal-lad-eer
balladry=bal-lad-ry
ballast=bal-last
ballet=bal-let
ballets=bal-lets
balletomane=bal-let-o-mane
ballerina=bal-le-ri-na
ballistic=bal-lis-tic
ballistics=bal-lis-tics
balloon=bal-loon
ballot=bal-lot
balloted=bal-lot-ed
balloter=bal-lot-er
balloting=bal-lot-ing
ballyhoo=bal-ly-hoo
balsa=bal-sa
balsam=bal-sam
baltic=bal-tic
baltimore=bal-ti-more
baluster=bal-us-ter
balustered=bal-us-tered
balustrade=bal-us-trade
bamboo=bam-boo
bamboozle=bam-boo-zle
bamboozler=bam-boo-zler
ban=ban
band=band
bandsman=bands-man
bandage=band-age
bandaged=band-aged
bandaging=band-ag-ing
bandbox=band-box
banded=band-ed
bander=band-er
banding=band-ing
bandmaster=band-mas-ter
bandstand=band-stand
bandwagon=band-wag-on
bandwidth=band-width
bane=bane
baneful=bane-ful
bang=bang
bangs=bangs
bangkok=bang-kok
bangladesh=bang-la-desh
bank=bank
banks=banks
bankable=bank-a-ble
bankbook=bank-book
banker=bank-er
banking=bank-ing
bankroll=bank-roll
bankrupt=bank-rupt
bankruptcy=bank-rupt-cy
banns=banns
bans=bans
bandanna=ban-dan-na
bandeau=ban-deau
banderole=ban-de-role
bandied=ban-died
bandit=ban-dit
bandits=ban-dits
banditry=ban-dit-ry
banditti=ban-dit-ti
bandicoot=ban-di-coot
bandoleer=ban-do-leer
bandy=ban-dy
bandying=ban-dy-ing
bangle=ban-gle
bangui=ban-gui
banish=ban-ish
banishment=ban-ish-ment
banister=ban-is-ter
banisters=ban-is-ters
banjo=ban-jo
banjoist=ban-jo-ist
banner=ban-ner
banning=ban-ning
banning=ban-ning
bannock=ban-nock
banquet=ban-quet
banquette=ban-quette
banqueted=ban-quet-ed
banqueter=ban-quet-er
banqueting=ban-quet-ing
banshee=ban-shee
bantam=ban-tam
bantam=ban-tam
banter=ban-ter
banyan=ban-yan
banzai=ban-zai
baptism=bap-tism
baptist=bap-tist
baptistery=bap-tist-er-y
baptismal=bap-tis-mal
baptistery=bap-tis-ter-y
baptize=bap-tize
baptized=bap-tized
baptizer=bap-tiz-er
baptizing=bap-tiz-ing
bar=bar
bar=bar
barb=barb
barbed=barbed
bard=bard
bard=bard
bardic=bard-ic
bare=bare
bareback=bare-back
barefaced=bare-faced
barefoot=bare-foot
barehanded=bare-hand-ed
bareheaded=bare-head-ed
barelegged=bare-leg-ged
barely=bare-ly
bareness=bare-ness
barge=barge
barging=barg-ing
bark=bark
barkentine=bark-en-tine
barker=bark-er
barking=bark-ing
barn=barn
barnstorm=barn-storm
barnyard=barn-yard
barque=barque
barred=barred
bartlett=bart-lett
barbaric=bar-bar-ic
barbarian=bar-bar-i-an
barbarity=bar-bar-i-ty
barbados=bar-ba-dos
barbara=bar-ba-ra
barbarism=bar-ba-rism
barbarize=bar-ba-rize
barbarized=bar-ba-rized
barbarous=bar-ba-rous
barbel=bar-bel
barbell=bar-bell
barber=bar-ber
barber=bar-ber
barberry=bar-ber-ry
barbershop=bar-ber-shop
barbecue=bar-be-cue
barbecued=bar-be-cued
barbecuing=bar-be-cu-ing
barbican=bar-bi-can
barbital=bar-bi-tal
barbiturate=bar-bi-tu-rate
barbituric=bar-bi-tu-ric
barcarole=bar-ca-role
barcelona=bar-ce-lon-a
barcelona=bar-ce-lo-na
barer=bar-er
barest=bar-est
barfly=bar-fly
bargain=bar-gain
bargainer=bar-gain-er
baric=bar-ic
baring=bar-ing
baring=bar-ing
barite=bar-ite
baritone=bar-i-tone
barium=bar-i-um
barkeep=bar-keep
barkeeper=bar-keep-er
barkentine=bar-ken-tine
barley=bar-ley
barmaid=bar-maid
barman=bar-man
barmen=bar-men
barnacle=bar-na-cle
barnacled=bar-na-cled
baron=bar-on
baronage=bar-on-age
baroness=bar-on-ess
baronet=bar-on-et
baronetcy=bar-on-et-cy
barograph=bar-o-graph
barometric=bar-o-met-ric
barony=bar-o-ny
barrack=bar-rack
barracks=bar-racks
barrage=bar-rage
barraged=bar-raged
barraging=bar-rag-ing
barracuda=bar-ra-cu-da
barratrous=bar-ra-trous
barratry=bar-ra-try
barrel=bar-rel
barreled=bar-reled
barrelled=bar-relled
barreling=bar-rel-ing
barrelling=bar-rel-ling
barren=bar-ren
barrens=bar-rens
barrenness=bar-ren-ness
barrette=bar-rette
barring=bar-ring
barrio=bar-rio
barrios=bar-rios
barrister=bar-ris-ter
barricade=bar-ri-cade
barricaded=bar-ri-cad-ed
barricader=bar-ri-cad-er
barrier=bar-ri-er
barroom=bar-room
barrow=bar-row
barrow=bar-row
barstool=bar-stool
bartender=bar-tend-er
barter=bar-ter
barterer=bar-ter-er
baryon=bar-y-on
base=base
baseball=base-ball
baseboard=base-board
baseborn=base-born
baseless=base-less
baseline=base-line
basely=base-ly
basement=base-ment
baseness=base-ness
bash=bash
bashful=bash-ful
bashfully=bash-ful-ly
bask=bask
bass=bass
basses=bass-es
bassist=bass-ist
basswood=bass-wood
bast=bast
baste=baste
basted=bast-ed
basting=bast-ing
basalt=bas-alt
bases=bas-es
basic=bas-ic
basil=bas-il
basil=bas-il
basing=bas-ing
basilar=bas-i-lar
basilisk=bas-i-lisk
basket=bas-ket
basketball=bas-ket-ball
basketful=bas-ket-ful
basketlike=bas-ket-like
basketwork=bas-ket-work
basset=bas-set
bassinet=bas-si-net
basso=bas-so
basso=bas-so
bassoon=bas-soon
bassoonist=bas-soon-ist
bastard=bas-tard
bastardize=bas-tard-ize
bastardly=bas-tard-ly
bastardy=bas-tard-y
bastardy=bas-tar-dy
bastion=bas-tion
bastioned=bas-tioned
bastinado=bas-ti-na-do
bastion=bas-ti-on
bat=bat
batch=batch
bate=bate
bates=bates
bath=bath
bath=bath
bathe=bathe
bather=bath-er
bathers=bath-ers
bathhouse=bath-house
bathhouses=bath-hous-es
bathing=bath-ing
batholith=bath-o-lith
bathrobe=bath-robe
bathroom=bath-room
bathtub=bath-tub
bats=bats
batsman=bats-man
bated=bat-ed
bating=bat-ing
batman=bat-man
batman=bat-man
battalion=bat-tal-ion
battalion=bat-tal-i-on
batted=bat-ted
batten=bat-ten
batter=bat-ter
batteries=bat-ter-ies
battery=bat-ter-y
battery=bat-ter-y
batteries=bat-te-ries
batting=bat-ting
battier=bat-ti-er
battiest=bat-ti-est
battle=bat-tle
battled=bat-tled
battler=bat-tler
battledore=bat-tle-dore
battlefield=bat-tle-field
battleground=bat-tle-ground
battlement=bat-tle-ment
battleship=bat-tle-ship
batty=bat-ty
batwoman=bat-wom-an
baud=baud
bauxite=baux-ite
bauble=bau-ble
bawd=bawd
bawdier=bawd-i-er
bawdiest=bawd-i-est
bawdily=bawd-i-ly
bawdiness=bawd-i-ness
bawdry=bawd-ry
bawdy=bawd-y
bawl=bawl
bawler=bawl-er
bawdry=baw-dry
bay=bay
bayberry=bay-ber-ry
bayou=bay-ou
bayonet=bay-o-net
bayoneted=bay-o-net-ed
bayoneting=bay-o-net-ing
bayonetted=bay-o-net-ted
baba=ba-ba
babel=ba-bel
babied=ba-bied
baboon=ba-boon
baboonish=ba-boon-ish
babushka=ba-bush-ka
baby=ba-by
babyhood=ba-by-hood
babying=ba-by-ing
babyish=ba-by-ish
bacillary=ba-cil-lar-y
bacilli=ba-cil-li
bacillus=ba-cil-lus
bacon=ba-con
bacon=ba-con
bagasse=ba-gasse
bagel=ba-gel
baguette=ba-guette
baker=ba-ker
bakelite=ba-ke-lite
baklava=ba-kla-va
baleen=ba-leen
baloney=ba-lo-ney
banal=ba-nal
banality=ba-nal-i-ty
banally=ba-nal-ly
banana=ba-nan-a
banana=ba-na-na
bananas=ba-na-nas
baobab=ba-o-bab
bar=ba-r
barometer=ba-rom-e-ter
barometry=ba-rom-e-try
baron=ba-ron
baroque=ba-roque
barouche=ba-rouche
baronial=ba-ro-ni-al
basal=ba-sal
basalt=ba-salt
basally=ba-sal-ly
basaltic=ba-sal-tic
bases=ba-ses
basic=ba-sic
basicity=ba-sic-i-ty
basilica=ba-sil-i-ca
basin=ba-sin
basis=ba-sis
basically=ba-si-cal-ly
bateau=ba-teau
bathetic=ba-thet-ic
bathos=ba-thos
batik=ba-tik
batiste=ba-tiste
baton=ba-ton
baton=ba-ton
batrachian=ba-tra-chi-an
bayonne=ba-yonne
bazaar=ba-zaar
bazooka=ba-zoo-ka
beach=beach
beach=beach
beachhead=beach-head
bead=bead
beaded=bead-ed
beading=bead-ing
beadier=bead-i-er
beadiest=bead-i-est
beadwork=bead-work
beady=bead-y
beak=beak
beaker=beak-er
beaklike=beak-like
beam=beam
beaming=beam-ing
bean=bean
beanbag=bean-bag
beaneries=bean-er-ies
beanery=bean-er-y
beanie=bean-ie
beanlike=bean-like
beano=bean-o
bear=bear
bear=bear
beard=beard
beard=beard
bearded=beard-ed
bearding=beard-ing
beardless=beard-less
bearable=bear-a-ble
bearer=bear-er
bearer=bear-er
bearing=bear-ing
bearings=bear-ings
bearish=bear-ish
bearskin=bear-skin
beast=beast
beastlier=beast-li-er
beastliest=beast-li-est
beastly=beast-ly
beat=beat
beaten=beat-en
beater=beat-er
beating=beat-ing
beatnik=beat-nik
beau=beau
beaut=beaut
beaux=beaux
beauish=beau-ish
beaujolais=beau-jo-lais
beaujolais=beau-jo-lais
beaumont=beau-mont
beauteous=beau-te-ous
beautician=beau-ti-cian
beautified=beau-ti-fied
beautifier=beau-ti-fi-er
beautiful=beau-ti-ful
beautify=beau-ti-fy
beauty=beau-ty
beacon=bea-con
beaconless=bea-con-less
beadle=bea-dle
beadle=bea-dle
beagle=bea-gle
beaver=bea-ver
beaver=bea-ver
beck=beck
beck=beck
beckon=beck-on
beckoner=beck-on-er
bed=bed
bed=bed
beds=beds
bedbug=bed-bug
bedclothes=bed-clothes
beddable=bed-da-ble
bedded=bed-ded
bedding=bed-ding
bedfast=bed-fast
bedfellow=bed-fel-low
bedford=bed-ford
bedlam=bed-lam
bedpan=bed-pan
bedpost=bed-post
bedridden=bed-rid-den
bedrock=bed-rock
bedroll=bed-roll
bedroom=bed-room
bedside=bed-side
bedsore=bed-sore
bedspread=bed-spread
bedspring=bed-spring
bedstead=bed-stead
bedtime=bed-time
bee=bee
bee=bee
beech=beech
beechen=beech-en
beechnut=beech-nut
beef=beef
beefburger=beef-burg-er
beefburger=beef-bur-ger
beefeater=beef-eat-er
beefier=beef-i-er
beefiest=beef-i-est
beefsteak=beef-steak
beefy=beef-y
been=been
beep=beep
beeper=beep-er
beer=beer
beer=beer
beers=beers
beeswax=bees-wax
beet=beet
beeves=beeves
beehive=bee-hive
beekeeper=bee-keep-er
beekeeping=bee-keep-ing
beelike=bee-like
beeline=bee-line
beethoven=bee-tho-ven
beetle=bee-tle
beg=beg
beggar=beg-gar
beggarly=beg-gar-ly
beggary=beg-gar-y
begin=beg-in
beguine=beg-uine
beige=beige
beirut=bei-rut
bel=bel
bel=bel
belch=belch
bell=bell
bell=bell
belle=belle
belle=belle
bellboy=bell-boy
bellflower=bell-flow-er
bellflower=bell-flow-er
bellhop=bell-hop
bellman=bell-man
bellwether=bell-weth-er
belt=belt
belted=belt-ed
belting=belt-ing
beltway=belt-way
beldam=bel-dam
belfast=bel-fast
belfry=bel-fry
belgian=bel-gian
belgium=bel-gium
belgrade=bel-grade
belladonna=bel-la-don-na
belletrist=bel-let-rist
bellied=bel-lied
belligerent=bel-lig-er-ent
bellingham=bel-ling-ham
bellicose=bel-li-cose
bellow=bel-low
bellow=bel-low
bellows=bel-lows
bellows=bel-lows
belly=bel-ly
bellyache=bel-ly-ache
bellyached=bel-ly-ached
bellyful=bel-ly-ful
belvedere=bel-ve-dere
bench=bench
benchmark=bench-mark
bend=bend
bend=bend
bends=bends
bendable=bend-a-ble
bender=bend-er
bending=bend-ing
bene=bene
bent=bent
bentwood=bent-wood
bene=ben-e
benedict=ben-e-dict
benedict=ben-e-dict
benedictine=ben-e-dic-tine
benediction=ben-e-dic-tion
benefactor=ben-e-fac-tor
benefice=ben-e-fice
benefit=ben-e-fit
benefit=ben-e-fit
benefited=ben-e-fit-ed
beneficial=ben-e-fi-cial
beneficiary=ben-e-fi-ciar-y
beneficiary=ben-e-fi-ci-ar-y
benison=ben-i-son
benjamin=ben-ja-min
benjamin=ben-ja-min
benny=ben-ny
benny=ben-ny
benthal=ben-thal
benthic=ben-thic
benthos=ben-thos
bentonite=ben-ton-ite
benzene=ben-zene
benzedrine=ben-ze-drine
benzine=ben-zine
benzoate=ben-zo-ate
benzocaine=ben-zo-caine
benzoic=ben-zo-ic
benzoin=ben-zo-in
berg=berg
berg=berg
berkeley=berke-ley
berth=berth
berceuse=ber-ceuse
bergen=ber-gen
beriberi=ber-i-ber-i
berkelium=ber-ke-li-um
berlin=ber-lin
berlin=ber-lin
berman=ber-man
bermuda=ber-mu-da
bernard=ber-nard
berried=ber-ried
berry=ber-ry
berry=ber-ry
berrylike=ber-ry-like
berserk=ber-serk
bertha=ber-tha
bertha=ber-tha
beryl=ber-yl
beryl=ber-yl
beryline=ber-yl-ine
best=best
best=best
bessemer=bes-se-mer
bestial=bes-tial
bestialize=bes-tial-ize
bestially=bes-tial-ly
bestial=bes-ti-al
bestialize=bes-ti-al-ize
bestiality=bes-ti-al-i-ty
bestiaries=bes-ti-ar-ies
bestiary=bes-ti-ar-y
bet=bet
bete=bete
bethel=beth-el
bethel=beth-el
bethlehem=beth-le-hem
betted=bet-ted
better=bet-ter
betterment=bet-ter-ment
betting=bet-ting
bettor=bet-tor
bevel=bev-el
beveled=bev-eled
bevelled=bev-elled
beveler=bev-el-er
beveling=bev-el-ing
bevelling=bev-el-ling
beverage=bev-er-age
beverly=bev-er-ly
bevies=bev-ies
bevy=bev-y
bey=bey
bezel=bez-el
beatified=be-at-i-fied
beatify=be-at-i-fy
beatifying=be-at-i-fy-ing
beatitude=be-at-i-tude
beatitude=be-at-i-tude
beatific=be-a-tif-ic
becalm=be-calm
becalmed=be-calmed
became=be-came
because=be-cause
becloud=be-cloud
become=be-come
becoming=be-com-ing
becomingly=be-com-ing-ly
bedaub=be-daub
bedazzle=be-daz-zle
bedeck=be-deck
bedevil=be-dev-il
bedeviled=be-dev-iled
bedevilled=be-dev-illed
bedeviling=be-dev-il-ing
bedew=be-dew
bedim=be-dim
bedimmed=be-dimmed
bedimming=be-dim-ming
bedizen=be-di-zen
bedraggle=be-drag-gle
befall=be-fall
befallen=be-fall-en
befell=be-fell
befit=be-fit
befitted=be-fit-ted
befitting=be-fit-ting
befog=be-fog
befogged=be-fogged
befogging=be-fog-ging
before=be-fore
beforehand=be-fore-hand
befoul=be-foul
befriend=be-friend
befuddle=be-fud-dle
befuddler=be-fud-dler
began=be-gan
begat=be-gat
beget=be-get
begetter=be-get-ter
begetting=be-get-ting
begin=be-gin
beginner=be-gin-ner
beginning=be-gin-ning
begonia=be-gon-ia
begot=be-got
begotten=be-got-ten
begrime=be-grime
begrimed=be-grimed
begriming=be-grim-ing
begrudge=be-grudge
begrudged=be-grudged
begrudging=be-grudg-ing
beguile=be-guile
beguiled=be-guiled
beguiler=be-guil-er
beguiling=be-guil-ing
beguine=be-guine
begum=be-gum
begun=be-gun
behalf=be-half
behave=be-have
behaved=be-haved
behavior=be-hav-ior
behavioral=be-hav-ior-al
behead=be-head
beheld=be-held
behest=be-hest
behemoth=be-he-moth
behind=be-hind
behindhand=be-hind-hand
behold=be-hold
beholden=be-hold-en
beholder=be-hold-er
beholding=be-hold-ing
behoof=be-hoof
behoove=be-hoove
behooved=be-hooved
behooving=be-hoov-ing
being=be-ing
bejewel=be-jew-el
bejeweled=be-jew-eled
bejewelled=be-jew-elled
bejeweling=be-jew-el-ing
bel=be-l
belated=be-lat-ed
belatedly=be-lat-ed-ly
belay=be-lay
belayed=be-layed
belaying=be-lay-ing
belabor=be-la-bor
beleaguer=be-lea-guer
belie=be-lie
belied=be-lied
belief=be-lief
believe=be-lieve
believed=be-lieved
believable=be-liev-a-ble
believer=be-liev-er
belittle=be-lit-tle
belittler=be-lit-tler
belier=be-li-er
belong=be-long
belonging=be-long-ing
belongings=be-long-ings
beloved=be-lov-ed
below=be-low
beluga=be-lu-ga
belying=be-ly-ing
bema=be-ma
bemata=be-ma-ta
bemire=be-mire
bemired=be-mired
bemiring=be-mir-ing
bemoan=be-moan
bemock=be-mock
bemuse=be-muse
bemused=be-mused
bemusing=be-mus-ing
bene=be-ne
beneath=be-neath
beneficent=be-nef-i-cent
benevolence=be-nev-o-lence
benevolent=be-nev-o-lent
benighted=be-night-ed
benign=be-nign
benignly=be-nign-ly
benignant=be-nig-nant
benignity=be-nig-ni-ty
benumb=be-numb
bequeath=be-queath
bequest=be-quest
berate=be-rate
berated=be-rat-ed
berating=be-rat-ing
bereave=be-reave
bereaving=be-reav-ing
bereft=be-reft
beret=be-ret
berets=be-rets
beryllium=be-ryl-li-um
beseech=be-seech
beseeched=be-seeched
beseecher=be-seech-er
beseeching=be-seech-ing
beseem=be-seem
beset=be-set
besetting=be-set-ting
beside=be-side
besides=be-sides
besiege=be-siege
besieged=be-sieged
besieger=be-sieg-er
besieging=be-sieg-ing
besmear=be-smear
besmirch=be-smirch
besmircher=be-smirch-er
besom=be-som
besot=be-sot
besotted=be-sot-ted
besotting=be-sot-ting
besought=be-sought
bespangle=be-span-gle
bespatter=be-spat-ter
bespeak=be-speak
bespeaking=be-speak-ing
bespoke=be-spoke
bespoken=be-spo-ken
bespread=be-spread
besprinkle=be-sprin-kle
bestir=be-stir
bestirred=be-stirred
bestirring=be-stir-ring
bestow=be-stow
bestowal=be-stow-al
bestrew=be-strew
bestrewn=be-strewn
bestrewing=be-strew-ing
bestride=be-stride
bestridden=be-strid-den
bestriding=be-strid-ing
beta=be-ta
beta=be-ta
betake=be-take
betaken=be-tak-en
betaking=be-tak-ing
betatron=be-ta-tron
betel=be-tel
bethesda=be-thes-da
bethink=be-think
bethought=be-thought
betide=be-tide
betided=be-tid-ed
betiding=be-tid-ing
betimes=be-times
betook=be-took
betoken=be-to-ken
betray=be-tray
betrayal=be-tray-al
betrayer=be-tray-er
betroth=be-troth
betrothed=be-trothed
betrothal=be-troth-al
between=be-tween
betwixt=be-twixt
bewail=be-wail
beware=be-ware
bewared=be-wared
bewaring=be-war-ing
bewigged=be-wigged
bewilder=be-wil-der
bewitch=be-witch
beyond=be-yond
bhang=bhang
bhutan=bhu-tan
bialy=bia-ly
bib=bib
bib=bib
bibliog=bibliog
bibber=bib-ber
bibbing=bib-bing
biblical=bib-li-cal
biblical=bib-li-cal
bibliography=bib-li-og-ra-phy
bibliophile=bib-li-o-phile
bibulous=bib-u-lous
bicker=bick-er
bickerer=bick-er-er
bickering=bick-er-ing
bid=bid
bide=bide
biddable=bid-da-ble
bidden=bid-den
bidder=bid-der
bidding=bid-ding
biddy=bid-dy
biddy=bid-dy
bided=bid-ed
biding=bid-ing
bier=bier
big=big
bight=bight
bigamist=big-a-mist
bigamous=big-a-mous
bigamy=big-a-my
bigger=big-ger
biggest=big-gest
biggie=big-gie
biggish=big-gish
bighorn=big-horn
bighorn=big-horn
bighorns=big-horns
bigmouth=big-mouth
bigness=big-ness
bigot=big-ot
bigoted=big-ot-ed
bigotry=big-ot-ry
bigwig=big-wig
bike=bike
biking=bik-ing
bile=bile
bilge=bilge
bilk=bilk
bilker=bilk-er
bill=bill
bill=bill
billboard=bill-board
billfold=bill-fold
billhead=bill-head
billing=bill-ing
bilious=bil-ious
bilious=bil-i-ous
billable=bil-la-ble
billet=bil-let
billeted=bil-let-ed
billeting=bil-let-ing
billiard=bil-liard
billiards=bil-liards
billings=bil-lings
billion=bil-lion
billionth=bil-lionth
billow=bil-low
billows=bil-lows
billowy=bil-low-y
billy=bil-ly
billy=bil-ly
bin=bin
bind=bind
bindable=bind-a-ble
binder=bind-er
binderies=bind-er-ies
bindery=bind-er-y
binding=bind-ing
bindweed=bind-weed
binge=binge
binghamton=bing-ham-ton
binaural=bin-au-ral
binder=bin-der
bingo=bin-go
binnacle=bin-na-cle
binocular=bin-oc-u-lar
binoculars=bin-oc-u-lars
birch=birch
birchen=birch-en
birches=birch-es
bird=bird
bird=bird
birdbath=bird-bath
birdbrain=bird-brain
birdhouse=bird-house
birdhouses=bird-hous-es
birdie=bird-ie
birdie=bird-ie
birdlike=bird-like
birdlime=bird-lime
birdseed=bird-seed
birth=birth
birthday=birth-day
birthmark=birth-mark
birthplace=birth-place
birthright=birth-right
birthstone=birth-stone
birmingham=bir-ming-ham
bishop=bish-op
bishop=bish-op
bishopric=bish-op-ric
bisque=bisque
biscuit=bis-cuit
bismarck=bis-marck
bismuth=bis-muth
bismuthal=bis-muth-al
bismuthic=bis-mu-thic
bissau=bis-sau
bistro=bis-tro
bit=bit
bitch=bitch
bitchier=bitch-i-er
bitchiest=bitch-i-est
bitchy=bitch-y
bite=bite
biter=bit-er
biting=bit-ing
bitingly=bit-ing-ly
bitten=bit-ten
bitter=bit-ter
bittern=bit-tern
bitters=bit-ters
bitterly=bit-ter-ly
bitterness=bit-ter-ness
bittersweet=bit-ter-sweet
bivouac=biv-ou-ac
bivouacked=biv-ou-acked
biannual=bi-an-nu-al
biannually=bi-an-nu-al-ly
bias=bi-as
bias=bi-as
biased=bi-ased
biassed=bi-assed
biasing=bi-as-ing
biassing=bi-as-sing
biathlon=bi-ath-lon
bialy=bi-a-ly
bibelot=bi-be-lot
bicameral=bi-cam-er-al
bicarbonate=bi-car-bo-nate
biceps=bi-ceps
bicepses=bi-ceps-es
bichloride=bi-chlo-ride
biconcave=bi-con-cave
biconvex=bi-con-vex
bicorporal=bi-cor-po-ral
bicuspid=bi-cus-pid
bicycle=bi-cy-cle
bicycler=bi-cy-cler
bicyclist=bi-cy-clist
bidet=bi-det
biennia=bi-en-ni-a
biennial=bi-en-ni-al
biennially=bi-en-ni-al-ly
biennium=bi-en-ni-um
bienniums=bi-en-ni-ums
bifocal=bi-fo-cal
bifocals=bi-fo-cals
bifurcate=bi-fur-cate
bifurcated=bi-fur-cat-ed
bijouterie=bi-jou-te-rie
bikini=bi-ki-ni
bikini=bi-ki-ni
bilateral=bi-lat-er-al
bilingual=bi-lin-gual
bimah=bi-mah
bimetallism=bi-met-al-lism
bimetallic=bi-me-tal-lic
bimonthly=bi-month-ly
binary=bi-na-ry
binomial=bi-no-mi-al
biographer=bi-og-ra-pher
biography=bi-og-ra-phy
biologist=bi-ol-o-gist
biology=bi-ol-o-gy
bionic=bi-on-ic
bionics=bi-on-ics
biopsy=bi-op-sy
bioptic=bi-op-tic
biotic=bi-ot-ic
biochemic=bi-o-chem-ic
biochemist=bi-o-chem-ist
biochemistry=bi-o-chem-is-try
biocide=bi-o-cide
biographic=bi-o-graph-ic
biologic=bi-o-log-ic
biological=bi-o-log-i-cal
biomedical=bi-o-med-i-cal
biophysics=bi-o-phys-ics
biophysical=bi-o-phys-i-cal
biophysicist=bi-o-phys-i-cist
biosphere=bi-o-sphere
biotin=bi-o-tin
biotite=bi-o-tite
bipartite=bi-par-tite
bipartisan=bi-par-ti-san
biped=bi-ped
biplane=bi-plane
bipolar=bi-po-lar
bipolarity=bi-po-lar-i-ty
biracial=bi-ra-cial
biretta=bi-ret-ta
bisect=bi-sect
bisection=bi-sec-tion
bisector=bi-sec-tor
bisexual=bi-sex-u-al
bisexually=bi-sex-u-al-ly
bison=bi-son
bistable=bi-sta-ble
bistros=bi-stros
bitumen=bi-tu-men
bituminous=bi-tu-mi-nous
bivalve=bi-valve
bivalent=bi-va-lent
biweekly=bi-week-ly
biyearly=bi-year-ly
bizarre=bi-zarre
bizarrely=bi-zarre-ly
blab=blab
blabber=blab-ber
blabbing=blab-bing
black=black
black=black
blackamoor=black-a-moor
blackball=black-ball
blackberry=black-ber-ry
blackbird=black-bird
blackboard=black-board
blacken=black-en
blackener=black-en-er
blackguard=black-guard
blackhead=black-head
blacking=black-ing
blackish=black-ish
blackjack=black-jack
blacklist=black-list
blackly=black-ly
blackmail=black-mail
blackness=black-ness
blackout=black-out
blacksmith=black-smith
blackthorn=black-thorn
blacktop=black-top
blade=blade
bladder=blad-der
blain=blain
blame=blame
blamed=blamed
blameful=blame-ful
blameless=blame-less
blameworthy=blame-wor-thy
blamable=blam-a-ble
blamably=blam-a-bly
blamer=blam-er
blaming=blam-ing
blanch=blanch
blanch=blanch
blanche=blanche
blancmange=blanc-mange
bland=bland
blandly=bland-ly
blandness=bland-ness
blank=blank
blankly=blank-ly
blankness=blank-ness
blandish=blan-dish
blandisher=blan-dish-er
blanket=blan-ket
blanketing=blan-ket-ing
blare=blare
blaring=blar-ing
blarney=blar-ney
blast=blast
blasted=blast-ed
blasting=blast-ing
blastoff=blast-off
blaspheme=blas-pheme
blasphemed=blas-phemed
blasphemer=blas-phem-er
blasphemous=blas-phe-mous
blasphemy=blas-phe-my
blather=blath-er
blatting=blat-ting
blaze=blaze
blaze=blaze
blazer=blaz-er
blazes=blaz-es
blazing=blaz-ing
blatant=bla-tant
blatantly=bla-tant-ly
blatancy=bla-tan-cy
blazon=bla-zon
bleach=bleach
bleacher=bleach-er
bleachers=bleach-ers
bleak=bleak
bleakish=bleak-ish
bleakly=bleak-ly
bleakness=bleak-ness
blear=blear
blearier=blear-i-er
bleariest=blear-i-est
bleary=blear-y
bleat=bleat
bleed=bleed
bleeder=bleed-er
bleeding=bleed-ing
bleep=bleep
blemish=blem-ish
blench=blench
blencher=blench-er
blend=blend
blended=blend-ed
blender=blend-er
blending=blend-ing
blent=blent
bless=bless
blessed=bless-ed
blessedly=bless-ed-ly
blessing=bless-ing
blest=blest
blessing=bles-sing
blew=blew
blight=blight
blimp=blimp
blind=blind
blinder=blind-er
blindfold=blind-fold
blinding=blind-ing
blindly=blind-ly
blindness=blind-ness
blink=blink
blinks=blinks
blinker=blink-er
blinkers=blink-ers
blinking=blink-ing
blintz=blintz
blintze=blintze
blinders=blin-ders
blip=blip
bliss=bliss
bliss=bliss
blissful=bliss-ful
blissfully=bliss-ful-ly
blister=blis-ter
blithe=blithe
blithe=blithe
blithely=blithe-ly
blitheness=blithe-ness
blithesome=blithe-some
blither=blith-er
blitz=blitz
blitz=blitz
blitzkrieg=blitz-krieg
blizzard=bliz-zard
bloat=bloat
bloated=bloat-ed
bloater=bloat-er
blob=blob
blobbing=blob-bing
bloc=bloc
block=block
block=block
blocked=blocked
blockade=block-ade
blockaded=block-ad-ed
blockader=block-ad-er
blockading=block-ad-ing
blockage=block-age
blockbuster=block-bust-er
blocker=block-er
blockhead=block-head
blockhouse=block-house
blocking=block-ing
blocky=block-y
bloke=bloke
blond=blond
blonde=blonde
blondness=blond-ness
blood=blood
blooded=blood-ed
bloodhound=blood-hound
bloodied=blood-ied
bloodier=blood-i-er
bloodiest=blood-i-est
bloodily=blood-i-ly
bloodiness=blood-i-ness
bloodless=blood-less
bloodline=blood-line
bloodmobile=blood-mo-bile
bloodroot=blood-root
bloodshed=blood-shed
bloodshot=blood-shot
bloodstain=blood-stain
bloodstone=blood-stone
bloodstream=blood-stream
bloody=blood-y
bloodying=blood-y-ing
bloom=bloom
bloomed=bloomed
bloomer=bloom-er
bloomers=bloom-ers
bloomfield=bloom-field
blooming=bloom-ing
bloomington=bloom-ing-ton
bloomier=bloom-i-er
bloomiest=bloom-i-est
bloomy=bloom-y
blooper=bloop-er
bloomer=bloo-mer
blossom=blos-som
blossom=blos-som
blossomy=blos-som-y
blot=blot
blotch=blotch
blotchier=blotch-i-er
blotchiest=blotch-i-est
blotchy=blotch-y
blotted=blot-ted
blotter=blot-ter
blotting=blot-ting
blouse=blouse
blousing=blous-ing
blouson=blous-on
blouson=blou-son
blow=blow
blown=blown
blowsy=blows-y
blowzier=blowz-i-er
blowziest=blowz-i-est
blowzy=blowz-y
blower=blow-er
blowfly=blow-fly
blowgun=blow-gun
blowing=blow-ing
blowier=blow-i-er
blowiest=blow-i-est
blowiness=blow-i-ness
blowout=blow-out
blowpipe=blow-pipe
blowtorch=blow-torch
blowup=blow-up
blowy=blow-y
blubber=blub-ber
blubberer=blub-ber-er
blubbery=blub-ber-y
bludgeon=bludg-eon
blue=blue
blue=blue
blues=blues
bluebell=blue-bell
blueberry=blue-ber-ry
bluebird=blue-bird
bluebonnet=blue-bon-net
bluebook=blue-book
bluebottle=blue-bot-tle
bluefish=blue-fish
bluefishes=blue-fish-es
bluegill=blue-gill
bluegrass=blue-grass
blueing=blue-ing
bluejacket=blue-jack-et
bluenose=blue-nose
bluepoint=blue-point
blueprint=blue-print
bluestocking=blue-stock-ing
bluff=bluff
bluffer=bluff-er
blunt=blunt
bluntly=blunt-ly
bluntness=blunt-ness
blunder=blun-der
blunderer=blun-der-er
blur=blur
blurb=blurb
blurt=blurt
blurring=blur-ring
blurry=blur-ry
blush=blush
blushful=blush-ful
blushfully=blush-ful-ly
bluster=blus-ter
blusterer=blus-ter-er
blustery=blus-ter-y
blucher=blu-cher
bluer=blu-er
bluest=blu-est
bluing=blu-ing
bluish=blu-ish
boar=boar
board=board
boarder=board-er
boarding=board-ing
boardinghouse=board-ing-house
boardwalk=board-walk
boast=boast
boaster=boast-er
boastful=boast-ful
boastfully=boast-ful-ly
boastingly=boast-ing-ly
boat=boat
boatel=boat-el
boater=boat-er
boating=boat-ing
boatman=boat-man
boatswain=boat-swain
bob=bob
bob=bob
bobs=bobs
bobber=bob-ber
bobbin=bob-bin
bobbing=bob-bing
bobble=bob-ble
bobby=bob-by
bobby=bob-by
bobbysocks=bob-by-socks
bobbysoxer=bob-by-sox-er
bobcat=bob-cat
bobolink=bob-o-link
bobsled=bob-sled
bobsledded=bob-sled-ded
bobsledder=bob-sled-der
bobtail=bob-tail
bobwhite=bob-white
bock=bock
boccie=boc-cie
bode=bode
boded=bod-ed
bodice=bod-ice
bodied=bod-ied
bodies=bod-ies
boding=bod-ing
bodiless=bod-i-less
bodily=bod-i-ly
bodkin=bod-kin
body=bod-y
bodyguard=bod-y-guard
bog=bog
bogging=bog-ging
boggle=bog-gle
boggy=bog-gy
boil=boil
boiled=boiled
boiler=boil-er
boiling=boil-ing
boisterous=bois-ter-ous
bold=bold
boldface=bold-face
boldfaced=bold-faced
boldly=bold-ly
boldness=bold-ness
bole=bole
boll=boll
boll=boll
bolt=bolt
bolivar=bol-i-var
bolivar=bol-i-var
bolivars=bol-i-vars
bolshevik=bol-she-vik
bolshevik=bol-she-vik
bolshevism=bol-she-vism
bolshevism=bol-she-vism
bolshevist=bol-she-vist
bolster=bol-ster
bolsterer=bol-ster-er
bomb=bomb
bomber=bomb-er
bombproof=bomb-proof
bombshell=bomb-shell
bombsight=bomb-sight
bomb=bom-b
bombard=bom-bard
bombardier=bom-bar-dier
bombast=bom-bast
bombastic=bom-bas-tic
bombay=bom-bay
bombazine=bom-ba-zine
bon=bon
bond=bond
bond=bond
bondsman=bonds-man
bondage=bond-age
bonded=bond-ed
bondholder=bond-hold-er
bondman=bond-man
bondwoman=bond-wom-an
bondwomen=bond-wom-en
bone=bone
boned=boned
boneblack=bone-black
bonefish=bone-fish
bonefishes=bone-fish-es
bonehead=bone-head
boneheaded=bone-head-ed
boneless=bone-less
bong=bong
bonbon=bon-bon
boner=bon-er
bonfire=bon-fire
bongo=bon-go
bongo=bon-go
bonhomie=bon-ho-mie
boning=bon-ing
bonier=bon-i-er
boniest=bon-i-est
boniness=bon-i-ness
bonjour=bon-jour
bonnet=bon-net
bonnet=bon-net
bonnie=bon-nie
bonnie=bon-nie
bonnier=bon-ni-er
bonniest=bon-ni-est
bonniness=bon-ni-ness
bonny=bon-ny
bonny=bon-ny
bonsai=bon-sai
bonsoir=bon-soir
bony=bon-y
bonzer=bon-zer
boo=boo
book=book
bookbinder=book-bind-er
bookcase=book-case
bookie=book-ie
booking=book-ing
bookish=book-ish
bookkeeper=book-keep-er
booklet=book-let
bookmaker=book-mak-er
bookmaking=book-mak-ing
bookmark=book-mark
bookmobile=book-mo-bile
bookplate=book-plate
bookrack=book-rack
bookseller=book-sel-ler
bookshelf=book-shelf
bookstore=book-store
bookworm=book-worm
boom=boom
boomerang=boom-er-ang
boomtown=boom-town
boon=boon
boondocks=boon-docks
boondoggle=boon-dog-gle
boor=boor
boorish=boor-ish
boorishly=boor-ish-ly
boost=boost
booster=boost-er
boot=boot
booth=booth
booth=booth
boots=boots
boots=boots
bootblack=boot-black
booted=boot-ed
bootee=boot-ee
booteries=boot-er-ies
bootery=boot-er-y
bootleg=boot-leg
bootlegged=boot-legged
bootlegger=boot-leg-ger
bootlegging=boot-leg-ging
bootless=boot-less
bootlessly=boot-less-ly
bootlick=boot-lick
bootlicker=boot-lick-er
bootstrap=boot-strap
booze=booze
boozer=booz-er
boozing=booz-ing
boozier=booz-i-er
booziest=booz-i-est
boozy=booz-y
booby=boo-by
boodle=boo-dle
booing=boo-ing
booty=boo-ty
bop=bop
bop=bop
bopping=bop-ping
bore=bore
boredom=bore-dom
born=born
born=born
borne=borne
borsch=borsch
borscht=borscht
bort=bort
bordeaux=bor-deaux
bordello=bor-del-lo
border=bor-der
border=bor-der
bordered=bor-dered
borderland=bor-der-land
borderline=bor-der-line
boring=bor-ing
borough=bor-ough
borrow=bor-row
borrow=bor-row
borrower=bor-row-er
borrowing=bor-row-ing
borstal=bor-stal
borzoi=bor-zoi
bosh=bosh
boskier=bosk-i-er
boskiest=bosk-i-est
bosky=bosk-y
boss=boss
bossism=boss-ism
bossier=boss-i-er
bossiest=boss-i-est
bossiness=boss-i-ness
bossy=boss-y
bosom=bos-om
bosomy=bos-om-y
bossy=bos-sy
boston=bos-ton
boston=bos-ton
boswell=bos-well
botch=botch
botcher=botch-er
botchier=botch-i-er
botchiest=botch-i-est
botchily=botch-i-ly
botchy=botch-y
both=both
bother=both-er
bothersome=both-er-some
botanist=bot-a-nist
botany=bot-a-ny
botswana=bot-swa-na
bottle=bot-tle
bottler=bot-tler
bottleneck=bot-tle-neck
bottom=bot-tom
bottoms=bot-toms
bottomless=bot-tom-less
bottommost=bot-tom-most
botulism=bot-u-lism
bouffant=bouf-fant
bough=bough
bought=bought
bouillon=bouil-lon
boule=boule
boules=boules
boulevard=boule-vard
boulder=boul-der
boulder=boul-der
boulevard=boul-e-vard
bounce=bounce
bouncer=bounc-er
bouncing=bounc-ing
bouncingly=bounc-ing-ly
bouncy=bounc-y
bound=bound
bounds=bounds
boundary=bound-a-ry
bounded=bound-ed
bounden=bound-en
bounder=bound-er
boundless=bound-less
bouncy=boun-cy
bounteous=boun-te-ous
bountiful=boun-ti-ful
bountiful=boun-ti-ful
bounty=boun-ty
bounty=boun-ty
bountyless=boun-ty-less
bourn=bourn
bourbon=bour-bon
bourbon=bour-bon
bourgeois=bour-geois
bourgeois=bour-geois
bourgeoisie=bour-geoi-sie
bout=bout
boucle=bou-cle
boudoir=bou-doir
boule=bou-le
bouquet=bou-quet
boutique=bou-tique
boutonniere=bou-ton-niere
boutonniere=bou-ton-ni-ere
bow=bow
bowdlerism=bowd-ler-ism
bowdlerize=bowd-ler-ize
bowedness=bowed-ness
bowl=bowl
bowls=bowls
bowler=bowl-er
bowling=bowl-ing
bowel=bow-el
bower=bow-er
bowers=bow-ers
bowerlike=bow-er-like
bowery=bow-er-y
bowery=bow-er-y
bowie=bow-ie
bowing=bow-ing
bowknot=bow-knot
bowleg=bow-leg
bowlegged=bow-leg-ged
bowler=bow-ler
bowlike=bow-like
bowline=bow-line
bowman=bow-man
bowsprit=bow-sprit
bowstring=bow-string
box=box
boxcar=box-car
boxer=box-er
boxer=box-er
boxers=box-ers
boxing=box-ing
boxlike=box-like
boxwood=box-wood
boy=boy
boycott=boy-cott
boyfriend=boy-friend
boyhood=boy-hood
boyish=boy-ish
boyishly=boy-ish-ly
boyishness=boy-ish-ness
boa=bo-a
boas=bo-as
boas=bo-as
bogey=bo-gey
bogeyman=bo-gey-man
bogota=bo-go-ta
bogus=bo-gus
bogy=bo-gy
bola=bo-la
bolas=bo-las
bolero=bo-le-ro
boleros=bo-le-ros
bolivia=bo-liv-i-a
boliviano=bo-li-via-no
boliviano=bo-li-vi-a-no
bolo=bo-lo
bologna=bo-lo-gna
bologna=bo-lo-gna
bolus=bo-lus
boluses=bo-lus-es
bona=bo-na
bonanza=bo-nan-za
bonito=bo-ni-to
bonus=bo-nus
bonuses=bo-nus-es
borate=bo-rate
borax=bo-rax
boreal=bo-re-al
boreal=bo-re-al
boric=bo-ric
boron=bo-ron
botanic=bo-tan-ic
botanical=bo-tan-i-cal
bovine=bo-vine
bra=bra
brace=brace
bracelet=brace-let
bracelets=brace-lets
bracken=brack-en
bracket=brack-et
bracketing=brack-et-ing
brackish=brack-ish
bract=bract
braces=brac-es
bracing=brac-ing
brad=brad
brad=brad
brae=brae
brag=brag
braggart=brag-gart
bragger=brag-ger
bragging=brag-ging
braid=braid
braided=braid-ed
braider=braid-er
braiding=braid-ing
braille=braille
brain=brain
brainchild=brain-child
brainier=brain-i-er
brainiest=brain-i-est
braininess=brain-i-ness
brainless=brain-less
brainpower=brain-pow-er
brainstorm=brain-storm
brainwash=brain-wash
brainy=brain-y
braise=braise
braising=brais-ing
brake=brake
brakeage=brake-age
brakeless=brake-less
brakeman=brake-man
braking=brak-ing
bramble=bram-ble
brambly=bram-bly
bran=bran
bran=bran
branch=branch
branch=branch
branching=branch-ing
branchlike=branch-like
brand=brand
brand=brand
brander=brand-er
brander=bran-der
brandied=bran-died
brandish=bran-dish
brandisher=bran-dish-er
brandy=bran-dy
brandying=bran-dy-ing
brash=brash
brashly=brash-ly
brashness=brash-ness
brass=brass
brassie=brass-ie
brassies=brass-ies
brassier=brass-i-er
brassiest=brass-i-est
brassy=brass-y
brass=bras-s
brasserie=bras-se-rie
brassiere=bras-siere
brat=brat
brattier=brat-ti-er
brattiest=brat-ti-est
bratty=brat-ty
bratwurst=brat-wurst
brave=brave
bravely=brave-ly
braveness=brave-ness
braver=brav-er
braveries=brav-er-ies
bravery=brav-er-y
bravest=brav-est
braving=brav-ing
brawl=brawl
brawler=brawl-er
brawn=brawn
brawnier=brawn-i-er
brawniest=brawn-i-est
brawnily=brawn-i-ly
brawniness=brawn-i-ness
brawny=brawn-y
bray=bray
braze=braze
brazer=braz-er
brazing=braz-ing
brazzaville=braz-za-ville
bracero=bra-ce-ro
braceros=bra-ce-ros
bravado=bra-va-do
bravo=bra-vo
bravura=bra-vu-ra
brazen=bra-zen
brazenly=bra-zen-ly
brazenness=bra-zen-ness
brazier=bra-zier
brazil=bra-zil
brazil=bra-zil
brazilian=bra-zil-ian
brazier=bra-zi-er
breach=breach
bread=bread
breadth=breadth
breadbasket=bread-bas-ket
breadboard=bread-board
breadfruit=bread-fruit
breadless=bread-less
breadstuff=bread-stuff
break=break
breakage=break-age
breakable=break-a-ble
breakaway=break-a-way
breakdown=break-down
breaker=break-er
breakfast=break-fast
breakfront=break-front
breaking=break-ing
breakneck=break-neck
breakout=break-out
breakpoint=break-point
breakthrough=break-through
breakup=break-up
breakwater=break-wa-ter
bream=bream
bream=bream
breast=breast
breastbone=breast-bone
breasting=breast-ing
breastplate=breast-plate
breaststroke=breast-stroke
breastwork=breast-work
breasted=breas-ted
breath=breath
breathe=breathe
breathable=breath-a-ble
breather=breath-er
breathing=breath-ing
breathier=breath-i-er
breathiest=breath-i-est
breathless=breath-less
breathtaking=breath-tak-ing
breathy=breath-y
breccia=brec-ci-a
bred=bred
breech=breech
breeches=breech-es
breed=breed
breeder=breed-er
breeding=breed-ing
breeze=breeze
breezeway=breeze-way
breezing=breez-ing
breezier=breez-i-er
breeziest=breez-i-est
breezily=breez-i-ly
breeziness=breez-i-ness
breezy=breez-y
brethren=breth-ren
breve=breve
breviary=brev-ia-ry
brevity=brev-i-ty
brew=brew
brewer=brew-er
brewer=brew-er
breweries=brew-er-ies
brewery=brew-er-y
brewing=brew-ing
brevet=bre-vet
breveted=bre-vet-ed
breveting=bre-vet-ing
brevetted=bre-vet-ted
brevetting=bre-vet-ting
breviaries=bre-vi-ar-ies
breviary=bre-vi-ar-y
bribe=bribe
bribeable=bribe-a-ble
bribable=brib-a-ble
briber=brib-er
briberies=brib-er-ies
bribery=brib-er-y
bribing=brib-ing
brick=brick
brick=brick
brickbat=brick-bat
bricklayer=brick-lay-er
bricklaying=brick-lay-ing
bride=bride
bride=bride
bridesmaid=brides-maid
bridegroom=bride-groom
bridge=bridge
bridge=bridge
bridgeable=bridge-a-ble
bridgehead=bridge-head
bridgeport=bridge-port
bridgework=bridge-work
bridges=bridg-es
bridging=bridg-ing
bridal=brid-al
bridally=brid-al-ly
brief=brief
briefs=briefs
briefcase=brief-case
briefing=brief-ing
briefly=brief-ly
briefness=brief-ness
brig=brig
brig=brig
bright=bright
bright=bright
brighten=bright-en
brightener=bright-en-er
brightly=bright-ly
brightness=bright-ness
brigand=brig-and
brigandage=brig-and-age
brigantine=brig-an-tine
brigantine=brig-an-tine
brigadier=brig-a-dier
brilliance=bril-liance
brilliant=bril-liant
brilliancy=bril-lian-cy
brim=brim
brimful=brim-ful
brimless=brim-less
brimming=brim-ming
brimstone=brim-stone
brine=brine
bring=bring
bringer=bring-er
bringing=bring-ing
brink=brink
brinkmanship=brink-man-ship
brindle=brin-dle
brindled=brin-dled
brinier=brin-i-er
briniest=brin-i-est
brininess=brin-i-ness
briny=brin-y
brisk=brisk
briskly=brisk-ly
briskness=brisk-ness
brisbane=bris-bane
brisket=bris-ket
brisling=bris-ling
bristle=bris-tle
bristly=bris-tly
bristol=bris-tol
britches=britch-es
britain=brit-ain
british=brit-ish
briton=brit-on
brittle=brit-tle
bridle=bri-dle
bridler=bri-dler
brier=bri-er
briery=bri-er-y
brigade=bri-gade
brio=bri-o
brioche=bri-oche
brioches=bri-och-es
briquette=bri-quette
britannic=bri-tan-nic
broach=broach
broacher=broach-er
broad=broad
broad=broad
broads=broads
broadband=broad-band
broadcast=broad-cast
broadcloth=broad-cloth
broaden=broad-en
broadloom=broad-loom
broadly=broad-ly
broadside=broad-side
broadsword=broad-sword
broadtail=broad-tail
broadway=broad-way
broccoli=broc-co-li
brogue=brogue
broil=broil
broiler=broil-er
broke=broke
bronze=bronze
bronzing=bronz-ing
bronzy=bronz-y
bronchi=bron-chi
bronchitic=bron-chit-ic
bronchial=bron-chi-al
bronchitis=bron-chi-tis
bronchus=bron-chus
bronco=bron-co
brontosaur=bron-to-saur
brooch=brooch
brood=brood
brooder=brood-er
broodier=brood-i-er
broodiest=brood-i-est
broody=brood-y
brook=brook
brook=brook
brooks=brooks
brooklet=brook-let
brookline=brook-line
brooklyn=brook-lyn
broom=broom
broomcorn=broom-corn
broomstick=broom-stick
broomy=broom-y
broth=broth
brothel=broth-el
brother=broth-er
brotherhood=broth-er-hood
brotherly=broth-er-ly
brothy=broth-y
brought=brought
brougham=brough-am
brouhaha=brou-ha-ha
brow=brow
brown=brown
brown=brown
brownie=brown-ie
brownie=brown-ie
browning=brown-ing
browning=brown-ing
brownish=brown-ish
brownout=brown-out
brownstone=brown-stone
browse=browse
browser=brows-er
browsing=brows-ing
browbeat=brow-beat
browbeaten=brow-beat-en
browning=brow-ning
brocade=bro-cade
brocaded=bro-cad-ed
brocading=bro-cad-ing
brochette=bro-chette
brochure=bro-chure
brogan=bro-gan
broguish=bro-guish
broken=bro-ken
brokenness=bro-ken-ness
broker=bro-ker
brokerage=bro-ker-age
bromide=bro-mide
bromidic=bro-mid-ic
bromine=bro-mine
bruise=bruise
bruiser=bruis-er
bruising=bruis-ing
bruit=bruit
brunch=brunch
brunswick=bruns-wick
brunt=brunt
brush=brush
brush=brush
brushed=brushed
brushlike=brush-like
brushwood=brush-wood
brushy=brush-y
brusque=brusque
brusquely=brusque-ly
brussels=brus-sels
brut=brut
brut=brut
brute=brute
brutish=brut-ish
brutishly=brut-ish-ly
brucellosis=bru-cel-lo-sis
bruin=bru-in
brunet=bru-net
brunette=bru-nette
brutal=bru-tal
brutalize=bru-tal-ize
brutalized=bru-tal-ized
brutality=bru-tal-i-ty
brutally=bru-tal-ly
brute=bru-te
bring=br-ing
bubble=bub-ble
bubbler=bub-bler
bubblier=bub-bli-er
bubbliest=bub-bli-est
bubbly=bub-bly
buck=buck
buck=buck
bucked=bucked
bucks=bucks
buckboard=buck-board
bucker=buck-er
bucket=buck-et
bucketful=buck-et-ful
buckeye=buck-eye
buckhound=buck-hound
buckish=buck-ish
buckishly=buck-ish-ly
buckle=buck-le
buckle=buck-le
buckler=buck-ler
buckleless=buck-le-less
buckling=buck-ling
buckram=buck-ram
bucksaw=buck-saw
buckshot=buck-shot
buckskin=buck-skin
buckskins=buck-skins
bucktooth=buck-tooth
buckwheat=buck-wheat
buccaneer=buc-ca-neer
bud=bud
bud=bud
budge=budge
budge=budge
budgerigar=budg-er-i-gar
budget=budg-et
budget=budg-et
budgetary=budg-et-ar-y
budgeted=budg-et-ed
budgeter=budg-et-er
budgie=budg-ie
budging=budg-ing
budded=bud-ded
budder=bud-der
buddha=bud-dha
buddha=bud-dha
buddhism=bud-dhism
buddhist=bud-dhist
buddy=bud-dy
buddy=bud-dy
budlike=bud-like
buff=buff
buffer=buff-er
buffalo=buf-fa-lo
buffalo=buf-fa-lo
buffaloed=buf-fa-loed
buffet=buf-fet
buffet=buf-fet
buffets=buf-fets
buffeted=buf-fet-ed
buffeter=buf-fet-er
buffoon=buf-foon
buffoonery=buf-foon-er-y
buffoonish=buf-foon-ish
bug=bug
bug=bug
bugs=bugs
bugaboo=bug-a-boo
bugbear=bug-bear
bugbearish=bug-bear-ish
buggy=bug-gy
build=build
builded=build-ed
builder=build-er
building=build-ing
buildup=build-up
built=built
bulb=bulb
bulbar=bulb-ar
bulbous=bulb-ous
bulge=bulge
bulge=bulge
bulgy=bulg-y
bulk=bulk
bulkhead=bulk-head
bulkier=bulk-i-er
bulkiest=bulk-i-est
bulkiness=bulk-i-ness
bulky=bulk-y
bull=bull
bull=bull
bulldog=bull-dog
bulldogged=bull-dogged
bulldoze=bull-doze
bulldozed=bull-dozed
bulldozer=bull-doz-er
bulldozing=bull-doz-ing
bullfight=bull-fight
bullfinch=bull-finch
bullfrog=bull-frog
bullhead=bull-head
bullheaded=bull-head-ed
bullhorn=bull-horn
bullish=bull-ish
bullock=bull-ock
bullpen=bull-pen
bullring=bull-ring
bulbul=bul-bul
bulgaria=bul-gar-i-a
bullet=bul-let
bulletin=bul-le-tin
bullied=bul-lied
bullion=bul-lion
bully=bul-ly
bullying=bul-ly-ing
bulrush=bul-rush
bulwark=bul-wark
bum=bum
bump=bump
bumper=bump-er
bumpier=bump-i-er
bumpiest=bump-i-est
bumpkin=bump-kin
bumpkinish=bump-kin-ish
bumptious=bump-tious
bumpy=bump-y
bumble=bum-ble
bumblebee=bum-ble-bee
bumbling=bum-bling
bummer=bum-mer
bumming=bum-ming
bun=bun
bunch=bunch
bunches=bunch-es
bunchier=bunch-i-er
bunchiest=bunch-i-est
bunchy=bunch-y
bung=bung
bunghole=bung-hole
bunk=bunk
bunker=bunk-er
bunkhouse=bunk-house
bunkhouses=bunk-hous-es
bunt=bunt
bunted=bunt-ed
bunting=bunt-ing
bunco=bun-co
bundle=bun-dle
bundler=bun-dler
bungalow=bun-ga-low
bungle=bun-gle
bungler=bun-gler
bunion=bun-ion
bunker=bun-ker
bunkum=bun-kum
bunny=bun-ny
bunny=bun-ny
bunsen=bun-sen
bunting=bun-ting
buoy=buoy
buoyant=buoy-ant
buoyantly=buoy-ant-ly
buoyancy=buoy-an-cy
bur=bur
bur=bur
burg=burg
burgh=burgh
burgher=burgh-er
burger=burg-er
burl=burl
burl=burl
burn=burn
burned=burned
burns=burns
burnt=burnt
burnable=burn-a-ble
burner=burn-er
burning=burn-ing
burnout=burn-out
burp=burp
burr=burr
burr=burr
burred=burred
burst=burst
bursting=burst-ing
burbank=bur-bank
burble=bur-ble
burden=bur-den
burdened=bur-dened
burdensome=bur-den-some
burdock=bur-dock
burgee=bur-gee
burgeon=bur-geon
burger=bur-ger
burgess=bur-gess
burgess=bur-gess
burglar=bur-glar
burglarize=bur-glar-ize
burglary=bur-gla-ry
burgle=bur-gle
burgundy=bur-gun-dy
buried=bur-ied
buries=bur-ies
burial=bur-i-al
burlap=bur-lap
burlesque=bur-lesque
burley=bur-ley
burley=bur-ley
burlington=bur-ling-ton
burlier=bur-li-er
burliest=bur-li-est
burliness=bur-li-ness
burly=bur-ly
burmese=bur-mese
burnish=bur-nish
burnisher=bur-nish-er
burnoose=bur-noose
burro=bur-ro
burrow=bur-row
burrower=bur-row-er
bursa=bur-sa
bursa=bur-sa
bursar=bur-sar
bursitis=bur-si-tis
burton=bur-ton
burton=bur-ton
bury=bur-y
bury=bur-y
burying=bur-y-ing
bus=bus
bush=bush
bush=bush
bushed=bushed
bushel=bush-el
bushel=bush-el
bushing=bush-ing
bushier=bush-i-er
bushiest=bush-i-est
bushman=bush-man
bushman=bush-man
bushmaster=bush-mas-ter
bushwhack=bush-whack
bushy=bush-y
business=busi-ness
businessman=busi-ness-man
buss=buss
bust=bust
buster=bust-er
busboy=bus-boy
busby=bus-by
buses=bus-es
busied=bus-ied
busing=bus-ing
busier=bus-i-er
busiest=bus-i-est
busily=bus-i-ly
buskin=bus-kin
busses=bus-ses
bussing=bus-sing
bustard=bus-tard
buster=bus-ter
bustle=bus-tle
bustled=bus-tled
bustler=bus-tler
busy=bus-y
busybodies=bus-y-bod-ies
busybody=bus-y-bod-y
busying=bus-y-ing
busyness=bus-y-ness
busywork=bus-y-work
but=but
butch=butch
butch=butch
butcher=butch-er
butcheries=butch-er-ies
butchery=butch-er-y
butt=butt
butt=butt
butte=butte
butte=butte
butler=but-ler
butler=but-ler
butter=but-ter
butterball=but-ter-ball
buttercup=but-ter-cup
butterfat=but-ter-fat
butterfish=but-ter-fish
butterfly=but-ter-fly
butteries=but-ter-ies
buttermilk=but-ter-milk
butternut=but-ter-nut
buttery=but-ter-y
butting=but-ting
buttock=but-tock
button=but-ton
buttons=but-tons
buttonhole=but-ton-hole
buttonhook=but-ton-hook
buttress=but-tress
buxom=bux-om
buxomness=bux-om-ness
buy=buy
buyer=buy-er
buying=buy-ing
buzz=buzz
buzzer=buzz-er
buzzard=buz-zard
bubo=bu-bo
bubonic=bu-bon-ic
bucharest=bu-cha-rest
bucolic=bu-col-ic
bucolics=bu-col-ics
budapest=bu-da-pest
bugle=bu-gle
bugled=bu-gled
bugler=bu-gler
bujumbura=bu-jum-bu-ra
buoy=bu-oy
bureau=bu-reau
bureaucracy=bu-reauc-ra-cy
bureaus=bu-reaus
bureaux=bu-reaux
bureaucrat=bu-reau-crat
bureaucratic=bu-reau-crat-ic
bureaucracy=bu-reau-cra-cy
burette=bu-rette
burundi=bu-run-di
butane=bu-tane
bwana=bwa-na
bye=bye
byte=byte
byzantine=byz-an-tine
bygone=by-gone
bylaw=by-law
byliner=by-lin-er
bypass=by-pass
bypassing=by-pass-ing
bypath=by-path
byplay=by-play
byroad=by-road
byronic=by-ron-ic
bystander=by-stand-er
bystreet=by-street
byway=by-way
byword=by-word
blow=b-low
cab=cab
cab=cab
cabala=cab-a-la
cabalistic=cab-a-lis-tic
cabaret=cab-a-ret
cabbage=cab-bage
cabby=cab-by
cabdriver=cab-driv-er
cabin=cab-in
cabinet=cab-i-net
cabinetmaker=cab-i-net-mak-er
cabochon=cab-o-chon
cabriolet=cab-ri-o-let
cache=cache
cachepot=cache-pot
caching=cach-ing
cackle=cack-le
cackler=cack-ler
cacciatore=cac-cia-to-re
cacti=cac-ti
cactoid=cac-toid
cactus=cac-tus
cactuses=cac-tus-es
cad=cad
cad=cad
cadge=cadge
cadger=cadg-er
cadging=cadg-ing
caddie=cad-die
caddied=cad-died
caddish=cad-dish
caddishly=cad-dish-ly
caddying=cad-dy-ing
cadillac=cad-il-lac
cadmic=cad-mic
cadmium=cad-mi-um
caesar=cae-sar
caesura=cae-su-ra
caesurae=cae-su-rae
caesural=cae-su-ral
caesuras=cae-su-ras
caesuric=cae-su-ric
cafeteria=caf-e-te-ri-a
caffeine=caf-feine
caftan=caf-tan
cage=cage
cage=cage
cageling=cage-ling
cagey=cage-y
cager=cag-er
cagey=cag-ey
caging=cag-ing
cagier=cag-i-er
cagiest=cag-i-est
cagily=cag-i-ly
caginess=cag-i-ness
cairn=cairn
cairns=cairns
caisson=cais-son
caiman=cai-man
caitiff=cai-tiff
cake=cake
cakewalk=cake-walk
caking=cak-ing
calf=calf
calfskin=calf-skin
call=call
caller=call-er
calling=call-ing
calm=calm
calmly=calm-ly
calmness=calm-ness
calve=calve
calves=calves
calving=calv-ing
calabash=cal-a-bash
calaboose=cal-a-boose
calamine=cal-a-mine
calcareous=cal-car-e-ous
calcic=cal-cic
calcine=cal-cine
calcined=cal-cined
calcining=cal-cin-ing
calcite=cal-cite
calcitic=cal-cit-ic
calcified=cal-ci-fied
calcify=cal-ci-fy
calcifying=cal-ci-fy-ing
calcimine=cal-ci-mine
calcimined=cal-ci-mined
calcium=cal-ci-um
calcutta=cal-cut-ta
calculate=cal-cu-late
calculated=cal-cu-lat-ed
calculable=cal-cu-la-ble
calculably=cal-cu-la-bly
calculation=cal-cu-la-tion
calculator=cal-cu-la-tor
calculus=cal-cu-lus
caldera=cal-de-ra
calderas=cal-de-ras
calends=cal-ends
calendar=cal-en-dar
calender=cal-en-der
calender=cal-en-der
caliphate=cal-iph-ate
calisthenic=cal-is-then-ic
caliber=cal-i-ber
calibrate=cal-i-brate
calibrated=cal-i-brat-ed
calibrator=cal-i-bra-tor
calibre=cal-i-bre
calico=cal-i-co
california=cal-i-for-nia
california=cal-i-for-ni-a
californium=cal-i-for-ni-um
caliper=cal-i-per
calla=cal-la
calla=cal-la
callas=cal-las
caller=cal-ler
calligraphy=cal-lig-ra-phy
calliope=cal-li-o-pe
calliope=cal-li-o-pe
callosity=cal-los-i-ty
callous=cal-lous
callously=cal-lous-ly
callow=cal-low
callowness=cal-low-ness
callus=cal-lus
callused=cal-lused
calluses=cal-lus-es
callusing=cal-lus-ing
calomel=cal-o-mel
calorie=cal-o-rie
calorie=cal-o-rie
calorific=cal-o-rif-ic
calorimeter=cal-o-rim-e-ter
calorimetry=cal-o-rim-e-try
calorimetric=cal-o-ri-met-ric
calumny=cal-um-ny
calumet=cal-u-met
calvary=cal-va-ry
calvary=cal-va-ry
calvin=cal-vin
calvinist=cal-vin-ist
calvities=cal-vi-ti-es
calyces=cal-y-ces
cam=cam
cam=cam
came=came
camp=camp
camp=camp
campcraft=camp-craft
camper=camp-er
campfire=camp-fire
campground=camp-ground
campier=camp-i-er
campiest=camp-i-est
camporee=camp-o-ree
campsite=camp-site
campstool=camp-stool
campy=camp-y
camber=cam-ber
cambia=cam-bi-a
cambial=cam-bi-al
cambium=cam-bi-um
cambiums=cam-bi-ums
cambodia=cam-bo-di-a
cambric=cam-bric
cambridge=cam-bridge
camden=cam-den
camel=cam-el
camera=cam-er-a
cameras=cam-er-as
cameraman=cam-er-a-man
cameo=cam-e-o
cameo=cam-e-o
cameos=cam-e-os
camisole=cam-i-sole
camouflage=cam-ou-flage
camomile=cam-o-mile
campaign=cam-paign
campaigner=cam-paign-er
campanile=cam-pa-ni-le
campaniles=cam-pa-ni-les
campanili=cam-pa-ni-li
campanology=cam-pa-nol-o-gy
camphor=cam-phor
camphoric=cam-phor-ic
camphorate=cam-pho-rate
campus=cam-pus
campuses=cam-pus-es
camshaft=cam-shaft
can=can
can=can
cane=cane
canebrake=cane-brake
canned=canned
cans=cans
cant=cant
cant=cant
canter=cant-er
cantingly=cant-ing-ly
canada=can-a-da
canalize=can-a-lize
canberra=can-ber-ra
cancan=can-can
cancel=can-cel
canceled=can-celed
cancelled=can-celled
cancelable=can-cel-a-ble
canceler=can-cel-er
canceling=can-cel-ing
cancelling=can-cel-ling
cancer=can-cer
cancer=can-cer
cancerous=can-cer-ous
candescent=can-des-cent
candela=can-de-la
candelabra=can-de-la-bra
candid=can-did
candidly=can-did-ly
candidness=can-did-ness
candied=can-died
candidate=can-di-date
candidacy=can-di-da-cy
candidature=can-di-da-ture
candle=can-dle
candler=can-dler
candlelight=can-dle-light
candlepin=can-dle-pin
candlepins=can-dle-pins
candlestick=can-dle-stick
candlewick=can-dle-wick
candor=can-dor
candy=can-dy
candy=can-dy
candying=can-dy-ing
caner=can-er
caning=can-ing
canister=can-is-ter
canker=can-ker
cankerous=can-ker-ous
cankerworm=can-ker-worm
canna=can-na
cannabis=can-na-bis
cannel=can-nel
canner=can-ner
canneries=can-ner-ies
cannery=can-ner-y
canning=can-ning
canning=can-ning
cannibal=can-ni-bal
cannier=can-ni-er
canniest=can-ni-est
cannily=can-ni-ly
canniness=can-ni-ness
cannon=can-non
cannon=can-non
cannonade=can-non-ade
cannonaded=can-non-ad-ed
cannonball=can-non-ball
cannoneer=can-non-eer
cannot=can-not
cannula=can-nu-la
canny=can-ny
canon=can-on
canonicity=can-on-ic-i-ty
canonize=can-on-ize
canonized=can-on-ized
canonizing=can-on-iz-ing
canonry=can-on-ry
canopied=can-o-pied
canopy=can-o-py
canopying=can-o-py-ing
cantankerous=can-tan-ker-ous
cantabile=can-ta-bi-le
cantaloupe=can-ta-loupe
cantata=can-ta-ta
canteen=can-teen
canter=can-ter
canterbury=can-ter-bur-y
canterbury=can-ter-bur-y
canthal=can-thal
cantharis=can-thar-is
canthus=can-thus
canthus=can-thus
canticle=can-ti-cle
canticles=can-ti-cles
cantilever=can-ti-lev-er
cantilever=can-ti-le-ver
cantle=can-tle
canto=can-to
canton=can-ton
canton=can-ton
cantonal=can-ton-al
cantonese=can-ton-ese
cantonment=can-ton-ment
cantor=can-tor
cantor=can-tor
cantos=can-tos
canvas=can-vas
canvass=can-vass
canvasser=can-vass-er
canvasback=can-vas-back
canvaslike=can-vas-like
canyon=can-yon
canyon=can-yon
caoutchouc=caou-tchouc
cap=cap
cape=cape
cape=cape
capeskin=cape-skin
caps=caps
capful=cap-ful
capillary=cap-il-lar-y
capita=cap-i-ta
capital=cap-i-tal
capitalism=cap-i-tal-ism
capitalist=cap-i-tal-ist
capitalize=cap-i-tal-ize
capitally=cap-i-tal-ly
capitation=cap-i-ta-tion
capitol=cap-i-tol
capping=cap-ping
capricorn=cap-ri-corn
capriole=cap-ri-ole
capsize=cap-size
capsized=cap-sized
capsizing=cap-siz-ing
capsicum=cap-si-cum
capstan=cap-stan
capstone=cap-stone
capsule=cap-sule
capsuled=cap-suled
capsuling=cap-sul-ing
capsular=cap-su-lar
capsulate=cap-su-late
captain=cap-tain
captaincy=cap-tain-cy
caption=cap-tion
captious=cap-tious
captiously=cap-tious-ly
captive=cap-tive
captivity=cap-tiv-i-ty
captivate=cap-ti-vate
captivated=cap-ti-vat-ed
captivator=cap-ti-va-tor
captor=cap-tor
capture=cap-ture
captured=cap-tured
capturing=cap-tur-ing
car=car
car=car
card=card
card=card
cards=cards
cardboard=card-board
carder=card-er
cardholder=card-hold-er
carding=card-ing
cardsharp=card-sharp
care=care
care=care
carefree=care-free
careful=care-ful
carefully=care-ful-ly
careless=care-less
carelessly=care-less-ly
caretaker=care-tak-er
careworn=care-worn
carp=carp
carper=carp-er
carping=carp-ing
cart=cart
carte=carte
carte=carte
cartage=cart-age
cartable=cart-a-ble
carter=cart-er
cartwheel=cart-wheel
carve=carve
carver=carv-er
carving=carv-ing
carat=car-at
carabao=car-a-ba-o
caracole=car-a-cole
caramel=car-a-mel
caramelize=car-a-mel-ize
carapace=car-a-pace
caravan=car-a-van
caravel=car-a-vel
caraway=car-a-way
carbide=car-bide
carbine=car-bine
carbineer=car-bi-neer
carbolic=car-bol-ic
carbon=car-bon
carbonate=car-bon-ate
carbonated=car-bon-at-ed
carbonator=car-bon-a-tor
carbondale=car-bon-dale
carbonic=car-bon-ic
carbonless=car-bon-less
carboy=car-boy
carbohydrate=car-bo-hy-drate
carbolated=car-bo-lat-ed
carbonaceous=car-bo-na-ceous
carborundum=car-bo-run-dum
carbuncle=car-bun-cle
carburetor=car-bu-re-tor
carburize=car-bu-rize
carburized=car-bu-rized
carcass=car-cass
carcinogen=car-cin-o-gen
carcinogenic=car-cin-o-gen-ic
carcinoma=car-ci-no-ma
carcinomas=car-ci-no-mas
cardamom=car-da-mom
cardiac=car-di-ac
cardigan=car-di-gan
cardigan=car-di-gan
cardinal=car-di-nal
cardinalate=car-di-nal-ate
cardinally=car-di-nal-ly
cardiology=car-di-ol-o-gy
cardiogram=car-di-o-gram
cardiovascular=car-di-o-vas-cu-lar
carer=car-er
caret=car-et
carfare=car-fare
cargo=car-go
carhop=car-hop
caribbean=car-ib-be-an
caries=car-ies
carillon=car-il-lon
carillons=car-il-lons
caring=car-ing
caribou=car-i-bou
caribou=car-i-bou
caricature=car-i-ca-ture
caries=car-i-es
carious=car-i-ous
carload=car-load
carmine=car-mine
carnage=car-nage
carnal=car-nal
carnality=car-nal-i-ty
carnally=car-nal-ly
carnauba=car-nau-ba
carnation=car-na-tion
carnation=car-na-tion
carnelian=car-nel-ian
carney=car-ney
carnegie=car-ne-gie
carnival=car-ni-val
carnivore=car-ni-vore
carny=car-ny
carol=car-ol
carol=car-ol
caroled=car-oled
carolled=car-olled
caroler=car-ol-er
caroling=car-ol-ing
caroller=car-ol-ler
carolling=car-ol-ling
carom=car-om
carousel=car-ou-sel
carolina=car-o-li-na
carotene=car-o-tene
carpal=car-pal
carpel=car-pel
carpenter=car-pen-ter
carpenter=car-pen-ter
carpentry=car-pen-try
carpet=car-pet
carpetbag=car-pet-bag
carpeting=car-pet-ing
carpi=car-pi
carport=car-port
carpus=car-pus
carrageen=car-ra-geen
carrel=car-rel
carrel=car-rel
carriage=car-riage
carried=car-ried
carrier=car-ri-er
carrion=car-ri-on
carrot=car-rot
carroty=car-rot-y
carrousel=car-rou-sel
carry=car-ry
carry=car-ry
carryall=car-ry-all
carrying=car-ry-ing
carsick=car-sick
carson=car-son
cartel=car-tel
carter=car-ter
cartesian=car-te-sian
cartesian=car-te-si-an
cartilage=car-ti-lage
cartographer=car-tog-ra-pher
cartography=car-tog-ra-phy
carton=car-ton
cartoon=car-toon
cartoonist=car-toon-ist
cartographic=car-to-graph-ic
cartridge=car-tridge
carver=car-ver
caryatid=car-y-at-id
caryatids=car-y-at-ids
caryatides=car-y-at-i-des
case=case
casebook=case-book
caseharden=case-hard-en
caseload=case-load
casement=case-ment
casement=case-ment
casework=case-work
caseworker=case-work-er
cash=cash
cash=cash
cashbook=cash-book
cashew=cash-ew
cashier=cash-ier
cashmere=cash-mere
cashmere=cash-mere
cask=cask
casque=casque
cast=cast
caste=caste
castaway=cast-a-way
caster=cast-er
casting=cast-ing
castoff=cast-off
casanova=cas-a-no-va
casbah=cas-bah
casbah=cas-bah
cascade=cas-cade
cascaded=cas-cad-ed
cascading=cas-cad-ing
cascara=cas-car-a
cascara=cas-ca-ra
casing=cas-ing
casket=cas-ket
cassandra=cas-san-dra
cassava=cas-sa-va
cassette=cas-sette
casserole=cas-se-role
cassia=cas-sia
cassia=cas-si-a
cassock=cas-sock
cassowary=cas-so-war-y
castanet=cas-ta-net
castanets=cas-ta-nets
castellan=cas-tel-lan
castigate=cas-ti-gate
castigated=cas-ti-gat-ed
castigator=cas-ti-ga-tor
castle=cas-tle
castled=cas-tled
castor=cas-tor
castor=cas-tor
castrate=cas-trate
castrated=cas-trat-ed
castrating=cas-trat-ing
castration=cas-tra-tion
castrator=cas-tra-tor
castro=cas-tro
casual=cas-u-al
casually=cas-u-al-ly
casualness=cas-u-al-ness
casualty=cas-u-al-ty
casuist=cas-u-ist
casuistry=cas-u-ist-ry
casuistic=cas-u-is-tic
cat=cat
catch=catch
catchall=catch-all
catcher=catch-er
catching=catch-ing
catchier=catch-i-er
catchiest=catch-i-est
catchment=catch-ment
catchpenny=catch-pen-ny
catchup=catch-up
catchword=catch-word
catchy=catch-y
catherine=cath-er-ine
catherine=cath-e-rine
catheter=cath-e-ter
cathode=cath-ode
cathodic=cath-od-ic
catholic=cath-o-lic
catholic=cath-o-lic
catabolic=cat-a-bol-ic
cataclysm=cat-a-clysm
cataclysmic=cat-a-clys-mic
catacomb=cat-a-comb
catafalque=cat-a-falque
catalepsy=cat-a-lep-sy
cataleptic=cat-a-lep-tic
catalog=cat-a-log
catalogue=cat-a-logue
cataloger=cat-a-log-er
catalyst=cat-a-lyst
catalytic=cat-a-lyt-ic
catalyze=cat-a-lyze
catalyzed=cat-a-lyzed
catalyzer=cat-a-lyz-er
catalyzing=cat-a-lyz-ing
catamaran=cat-a-ma-ran
catamount=cat-a-mount
catapult=cat-a-pult
cataract=cat-a-ract
catastrophic=cat-a-stroph-ic
catatonic=cat-a-ton-ic
catatonia=cat-a-to-ni-a
catbird=cat-bird
catboat=cat-boat
catcall=cat-call
caterpillar=cat-er-pil-lar
caterwaul=cat-er-waul
catechism=cat-e-chism
catechist=cat-e-chist
catechize=cat-e-chize
catechized=cat-e-chized
catechumen=cat-e-chu-men
categoric=cat-e-gor-ic
categorize=cat-e-go-rize
category=cat-e-go-ry
catenaries=cat-e-nar-ies
catenary=cat-e-nar-y
catenate=cat-e-nate
catfish=cat-fish
catfishes=cat-fish-es
catgut=cat-gut
cation=cat-i-on
catkin=cat-kin
catlike=cat-like
catnap=cat-nap
catnapped=cat-napped
catnapping=cat-nap-ping
catnip=cat-nip
catsup=cat-sup
cattail=cat-tail
cattier=cat-ti-er
cattiest=cat-ti-est
cattily=cat-ti-ly
cattiness=cat-ti-ness
cattle=cat-tle
cattleman=cat-tle-man
catty=cat-ty
catwalk=cat-walk
caught=caught
caulk=caulk
caulker=caulk-er
cauldron=caul-dron
cause=cause
causeless=cause-less
causeway=cause-way
causal=caus-al
causally=caus-al-ly
causative=caus-a-tive
causer=caus-er
causing=caus-ing
caustic=caus-tic
causticity=caus-tic-i-ty
caucasian=cau-ca-sian
caucasian=cau-ca-si-an
caucus=cau-cus
caucuses=cau-cus-es
caudal=cau-dal
caudally=cau-dal-ly
caudillo=cau-dil-lo
caudillos=cau-dil-los
cauliflower=cau-li-flow-er
causality=cau-sal-i-ty
causation=cau-sa-tion
causerie=cau-se-rie
cauterize=cau-ter-ize
cauterized=cau-ter-ized
caution=cau-tion
cautionary=cau-tion-ar-y
cautious=cau-tious
cautiously=cau-tious-ly
cave=cave
caveman=cave-man
cavalcade=cav-al-cade
cavalry=cav-al-ry
cavalryman=cav-al-ry-man
cavalier=cav-a-lier
cavalier=cav-a-lier
cavalierly=cav-a-lier-ly
cavern=cav-ern
cavernous=cav-ern-ous
cavil=cav-il
caviled=cav-iled
cavilled=cav-illed
caviler=cav-il-er
caviling=cav-il-ing
caviller=cav-il-ler
caving=cav-ing
caviar=cav-i-ar
cavitation=cav-i-ta-tion
cavitied=cav-i-tied
cavity=cav-i-ty
caw=caw
cay=cay
cayenne=cay-enne
cayenne=cay-enne
cayuse=cay-use
cabal=ca-bal
cabal=ca-bal
caballed=ca-balled
caballero=ca-bal-le-ro
caballeros=ca-bal-le-ros
caballing=ca-bal-ling
cabala=ca-ba-la
cabana=ca-ba-na
cable=ca-ble
cable=ca-ble
cablegram=ca-ble-gram
cabling=ca-bling
caboose=ca-boose
caboodle=ca-boo-dle
cacao=ca-ca-o
cacaos=ca-ca-os
cachet=ca-chet
cachets=ca-chets
cacophony=ca-coph-o-ny
cadaver=ca-dav-er
cadaveric=ca-dav-er-ic
cadaverous=ca-dav-er-ous
cadence=ca-dence
cadence=ca-dence
cadenced=ca-denced
cadenza=ca-den-za
cadenza=ca-den-za
cadet=ca-det
cadet=ca-det
cadetship=ca-det-ship
cadre=ca-dre
caducei=ca-du-ce-i
caduceus=ca-du-ce-us
cahoot=ca-hoot
cahoots=ca-hoots
cajole=ca-jole
cajoled=ca-joled
cajolement=ca-jole-ment
cajoler=ca-jol-er
cajoleries=ca-jol-er-ies
cajolery=ca-jol-er-y
cajoling=ca-jol-ing
calamitous=ca-lam-i-tous
calamity=ca-lam-i-ty
caladium=ca-la-di-um
calendula=ca-len-du-la
caliph=ca-liph
caliphate=ca-li-phate
caloric=ca-lor-ic
calumniate=ca-lum-ni-ate
calumnious=ca-lum-ni-ous
calypso=ca-lyp-so
calypso=ca-lyp-so
calyx=ca-lyx
calyxes=ca-lyx-es
camaraderie=ca-ma-ra-de-rie
camellia=ca-mel-lia
camellia=ca-mel-lia
camellia=ca-mel-li-a
camelopard=ca-mel-o-pard
canaan=ca-naan
canaille=ca-naille
canal=ca-nal
canalize=ca-nal-ize
canalized=ca-nal-ized
canalizing=ca-nal-iz-ing
canard=ca-nard
canaries=ca-nar-ies
canaries=ca-nar-ies
canary=ca-nar-y
canasta=ca-nas-ta
canadian=ca-na-di-an
canine=ca-nine
canoe=ca-noe
canoed=ca-noed
canoeing=ca-noe-ing
canoeist=ca-noe-ist
canon=ca-non
canonic=ca-non-ic
canonical=ca-non-i-cal
canonicals=ca-non-i-cals
capacitance=ca-pac-i-tance
capacitate=ca-pac-i-tate
capacitive=ca-pac-i-tive
capacitor=ca-pac-i-tor
capacity=ca-pac-i-ty
caparison=ca-par-i-son
capability=ca-pa-bil-i-ty
capable=ca-pa-ble
capably=ca-pa-bly
capacious=ca-pa-cious
caper=ca-per
capers=ca-pers
capillary=ca-pil-lar-y
capitulate=ca-pit-u-late
capita=ca-pi-ta
capon=ca-pon
caprice=ca-price
capriccio=ca-pric-ci-o
capriccios=ca-pric-ci-os
capricious=ca-pri-cious
carafe=ca-rafe
carabao=ca-ra-ba-o
carabaos=ca-ra-ba-os
caracas=ca-ra-cas
careen=ca-reen
careener=ca-reen-er
career=ca-reer
caress=ca-ress
caresser=ca-ress-er
carillon=ca-ril-lon
carina=ca-ri-na
carina=ca-ri-na
carotid=ca-rot-id
carotidal=ca-rot-id-al
carouse=ca-rouse
caroused=ca-roused
carousal=ca-rous-al
carouser=ca-rous-er
carousing=ca-rous-ing
casaba=ca-sa-ba
casein=ca-sein
casino=ca-si-no
casus=ca-sus
catabolism=ca-tab-o-lism
catalpa=ca-tal-pa
catalysis=ca-tal-y-sis
catarrh=ca-tarrh
catarrhal=ca-tarrh-al
catarrhous=ca-tarrh-ous
catastrophe=ca-tas-tro-phe
cater=ca-ter
caterer=ca-ter-er
catering=ca-ter-ing
catenary=ca-te-na-ry
catharsis=ca-thar-sis
cathartic=ca-thar-tic
cathedral=ca-the-dral
catholicism=ca-thol-i-cism
cave=ca-ve
caveat=ca-ve-at
cavort=ca-vort
cavy=ca-vy
cayuga=ca-yu-ga
cease=cease
ceaseless=cease-less
ceasing=ceas-ing
cede=cede
ceded=ced-ed
ceder=ced-er
ceding=ced-ing
ceiling=ceil-ing
cell=cell
cellblock=cell-block
celtic=celt-ic
celandine=cel-an-dine
celery=cel-er-y
celebrant=cel-e-brant
celebrate=cel-e-brate
celebrated=cel-e-brat-ed
celebrator=cel-e-bra-tor
celibate=cel-i-bate
celibacy=cel-i-ba-cy
cellar=cel-lar
cellarage=cel-lar-age
cellaret=cel-lar-et
cellist=cel-list
cello=cel-lo
cellophane=cel-lo-phane
cellular=cel-lu-lar
cellulose=cel-lu-lose
cellulosic=cel-lu-lo-sic
celsius=cel-si-us
cembalo=cem-ba-lo
cemeteries=cem-e-ter-ies
cemetery=cem-e-ter-y
cent=cent
cenotaph=cen-o-taph
cenotaphic=cen-o-taph-ic
censer=cen-ser
censor=cen-sor
censorship=cen-sor-ship
censorial=cen-so-ri-al
censorious=cen-so-ri-ous
censure=cen-sure
censured=cen-sured
censurable=cen-sur-a-ble
censurer=cen-sur-er
censuring=cen-sur-ing
census=cen-sus
censuses=cen-sus-es
centaur=cen-taur
centavo=cen-ta-vo
centennial=cen-ten-ni-al
center=cen-ter
center=cen-ter
centered=cen-tered
centerfold=cen-ter-fold
centering=cen-ter-ing
centerpiece=cen-ter-piece
centesimal=cen-tes-i-mal
centesimo=cen-tes-i-mo
centenary=cen-te-nar-y
centenary=cen-te-nar-y
centime=cen-time
centigrade=cen-ti-grade
centigram=cen-ti-gram
centiliter=cen-ti-li-ter
centimeter=cen-ti-me-ter
centipede=cen-ti-pede
central=cen-tral
centralism=cen-tral-ism
centralist=cen-tral-ist
centralize=cen-tral-ize
centrality=cen-tral-i-ty
centrally=cen-tral-ly
centric=cen-tric
centrifugal=cen-trif-u-gal
centripetal=cen-trip-e-tal
centrist=cen-trist
centrifuge=cen-tri-fuge
centurion=cen-tu-ri-on
century=cen-tu-ry
cerecloth=cere-cloth
cerement=cere-ment
cert=cert
ceramist=cer-a-mist
cerebella=cer-e-bel-la
cerebellum=cer-e-bel-lum
cerebral=cer-e-bral
cerebrally=cer-e-bral-ly
cerebrate=cer-e-brate
cerebrated=cer-e-brat-ed
cerebrum=cer-e-brum
ceremonial=cer-e-mo-ni-al
ceremonious=cer-e-mo-ni-ous
ceremony=cer-e-mo-ny
cermet=cer-met
certain=cer-tain
certainly=cer-tain-ly
certainty=cer-tain-ty
certificate=cer-tif-i-cate
certified=cer-ti-fied
certifier=cer-ti-fi-er
certify=cer-ti-fy
certifying=cer-ti-fy-ing
certitude=cer-ti-tude
cervix=cer-vix
cervixes=cer-vix-es
cervical=cer-vi-cal
cervices=cer-vi-ces
cess=cess
cesspool=cess-pool
cessation=ces-sa-tion
cession=ces-sion
ceylon=cey-lon
cecal=ce-cal
cecropia=ce-cro-pi-a
cecum=ce-cum
cedar=ce-dar
cedilla=ce-dil-la
celebrity=ce-leb-ri-ty
celerity=ce-ler-i-ty
celesta=ce-les-ta
celestial=ce-les-tial
celestial=ce-les-ti-al
celiac=ce-li-ac
cement=ce-ment
cementer=ce-ment-er
cementum=ce-men-tum
cenobite=ce-no-bite
cenobitic=ce-no-bit-ic
cephalic=ce-phal-ic
ceramic=ce-ram-ic
ceramics=ce-ram-ics
cereal=ce-re-al
cereus=ce-re-us
cereuses=ce-re-us-es
cerise=ce-rise
cerium=ce-ri-um
cerulean=ce-ru-le-an
cerumen=ce-ru-men
ceruminous=ce-ru-mi-nous
cesium=ce-si-um
cetacean=ce-ta-cean
chablis=chab-lis
chablis=chab-lis
chafe=chafe
chaff=chaff
chafferer=chaff-er-er
chafer=chaf-er
chaffer=chaf-fer
chaffinch=chaf-finch
chafing=chaf-ing
chain=chain
chain=chain
chair=chair
chairman=chair-man
chairwoman=chair-wom-an
chairwomen=chair-wom-en
chaise=chaise
chalk=chalk
chalkboard=chalk-board
chalkier=chalk-i-er
chalkiest=chalk-i-est
chalky=chalk-y
chalcedony=chal-ced-o-ny
chalice=chal-ice
challah=chal-lah
challahs=chal-lahs
challenge=chal-lenge
challenged=chal-lenged
challenger=chal-leng-er
challis=chal-lis
challis=chal-lis
champ=champ
chamber=cham-ber
chambers=cham-bers
chambers=cham-bers
chamberlain=cham-ber-lain
chamberlain=cham-ber-lain
chambermaid=cham-ber-maid
chambray=cham-bray
chamfer=cham-fer
chamois=cham-ois
chamomile=cham-o-mile
champagne=cham-pagne
champagne=cham-pagne
champaign=cham-paign
champaign=cham-paign
champion=cham-pi-on
chance=chance
chancing=chanc-ing
chancier=chanc-i-er
chanciest=chanc-i-est
chancy=chanc-y
change=change
changeable=change-a-ble
changeful=change-ful
changeless=change-less
changeling=change-ling
changeover=change-o-ver
changer=chang-er
changing=chang-ing
chant=chant
chanter=chant-er
chantey=chant-ey
chancel=chan-cel
chancellor=chan-cel-lor
chanceries=chan-cer-ies
chancery=chan-cer-y
chancre=chan-cre
chancroid=chan-croid
chandelier=chan-de-lier
chandler=chan-dler
chandler=chan-dler
chandlery=chan-dler-y
channel=chan-nel
channel=chan-nel
channeled=chan-neled
channelled=chan-nelled
channeling=chan-nel-ing
channelize=chan-nel-ize
chanson=chan-son
chanteuse=chan-teuse
chantey=chan-tey
chantry=chan-try
chap=chap
chaps=chaps
chaparral=chap-ar-ral
chapbook=chap-book
chapel=chap-el
chaperon=chap-er-on
chaperone=chap-er-one
chaperoned=chap-er-oned
chapfallen=chap-fall-en
chaplain=chap-lain
chaplaincy=chap-lain-cy
chaplet=chap-let
chapleted=chap-let-ed
chapman=chap-man
chapman=chap-man
chapping=chap-ping
chapter=chap-ter
char=char
char=char
chard=chard
charge=charge
charged=charged
chargeable=charge-a-ble
charger=charg-er
charging=charg-ing
charles=charles
charleston=charles-ton
charleston=charles-ton
charm=charm
charmer=charm-er
charming=charm-ing
charmingly=charm-ing-ly
chart=chart
character=char-ac-ter
characteristic=char-ac-ter-is-tic
charactery=char-ac-ter-y
charcoal=char-coal
charismatic=char-is-mat-ic
charier=char-i-er
chariest=char-i-est
charily=char-i-ly
chariness=char-i-ness
chariot=char-i-ot
charioteer=char-i-ot-eer
charitable=char-i-ta-ble
charitably=char-i-ta-bly
charity=char-i-ty
charity=char-i-ty
charlatan=char-la-tan
charley=char-ley
charlie=char-lie
charlie=char-lie
charlotte=char-lotte
charlotte=char-lotte
charlottesville=char-lottes-ville
charnel=char-nel
charring=char-ring
charter=char-ter
charterer=char-ter-er
chartreuse=char-treuse
charwoman=char-wom-an
charwomen=char-wom-en
chary=char-y
chase=chase
chase=chase
chasm=chasm
chaste=chaste
chastely=chaste-ly
chasteness=chaste-ness
chaster=chast-er
chastest=chast-est
chaser=chas-er
chasing=chas-ing
chasmal=chas-mal
chassis=chas-sis
chasten=chas-ten
chastener=chas-ten-er
chastise=chas-tise
chastised=chas-tised
chastiser=chas-tis-er
chastising=chas-tis-ing
chastity=chas-ti-ty
chasuble=chas-u-ble
chat=chat
chatelaine=chat-e-laine
chattanooga=chat-ta-noo-ga
chatted=chat-ted
chattel=chat-tel
chatter=chat-ter
chatterbox=chat-ter-box
chatterer=chat-ter-er
chatting=chat-ting
chattier=chat-ti-er
chattiest=chat-ti-est
chattily=chat-ti-ly
chattiness=chat-ti-ness
chatty=chat-ty
chauffeur=chauf-feur
chaunt=chaunt
chauvinism=chau-vin-ism
chauvinist=chau-vin-ist
chagrin=cha-grin
chagrinned=cha-grinned
chagrining=cha-grin-ing
chalet=cha-let
chalets=cha-lets
chameleon=cha-me-le-on
chaos=cha-os
chaotic=cha-ot-ic
chapeau=cha-peau
charade=cha-rade
charades=cha-rades
charisma=cha-ris-ma
chateau=cha-teau
cheap=cheap
cheapen=cheap-en
cheaply=cheap-ly
cheapness=cheap-ness
cheapskate=cheap-skate
cheat=cheat
cheater=cheat-er
cheatingly=cheat-ing-ly
check=check
checked=checked
checkable=check-a-ble
checkbook=check-book
checker=check-er
checkered=check-ered
checkers=check-ers
checkerberry=check-er-ber-ry
checkerboard=check-er-board
checkless=check-less
checkmate=check-mate
checkmated=check-mat-ed
checkoff=check-off
checkpoint=check-point
checkroom=check-room
checksum=check-sum
checkup=check-up
cheddar=ched-dar
cheek=cheek
cheekbone=cheek-bone
cheekier=cheek-i-er
cheekiest=cheek-i-est
cheekily=cheek-i-ly
cheekiness=cheek-i-ness
cheeky=cheek-y
cheep=cheep
cheeper=cheep-er
cheer=cheer
cheers=cheers
cheerful=cheer-ful
cheerfully=cheer-ful-ly
cheerier=cheer-i-er
cheeriest=cheer-i-est
cheerily=cheer-i-ly
cheeriness=cheer-i-ness
cheerleader=cheer-lead-er
cheerless=cheer-less
cheery=cheer-y
cheese=cheese
cheesecake=cheese-cake
cheesecloth=cheese-cloth
cheesiness=chees-i-ness
cheesy=chees-y
cheetah=chee-tah
chef=chef
chemist=chem-ist
chemistry=chem-is-try
chemical=chem-i-cal
chemically=chem-i-cal-ly
chemotherapy=chem-o-ther-a-py
chemurgic=chem-ur-gic
chemurgy=chem-ur-gy
chert=chert
cherty=chert-y
cherish=cher-ish
cherisher=cher-ish-er
cherokee=cher-o-kee
cherry=cher-ry
cherry=cher-ry
cherub=cher-ub
cherubs=cher-ubs
cherubim=cher-u-bim
chervil=cher-vil
cheshire=chesh-ire
chess=chess
chessboard=chess-board
chessman=chess-man
chest=chest
chestnut=chest-nut
chesapeake=ches-a-peake
chester=ches-ter
chevalier=chev-a-lier
cheviot=chev-i-ot
chevron=chev-ron
chew=chew
chewable=chew-a-ble
chewer=chew-er
chewier=chew-i-er
chewiest=chew-i-est
chewy=chew-y
cheyenne=chey-enne
chelate=che-late
chemise=che-mise
chenille=che-nille
cheroot=che-root
cherubic=che-ru-bic
chevalier=che-va-lier
cheviot=che-vi-ot
chic=chic
chick=chick
chick=chick
chickadee=chick-a-dee
chicken=chick-en
chickpea=chick-pea
chickweed=chick-weed
chicle=chic-le
chicly=chic-ly
chicory=chic-o-ry
chide=chide
chided=chid-ed
chider=chid-er
chidingly=chid-ing-ly
chief=chief
chiefdom=chief-dom
chiefly=chief-ly
chieftain=chief-tain
chiffon=chif-fon
chiffonier=chif-fo-nier
chifforobe=chif-fo-robe
chigger=chig-ger
chigoe=chig-oe
child=child
childbirth=child-birth
childhood=child-hood
childish=child-ish
childishly=child-ish-ly
childless=child-less
childlike=child-like
chill=chill
chillingly=chill-ing-ly
chillness=chill-ness
chilblain=chil-blain
children=chil-dren
chili=chil-i
chilies=chil-ies
chiller=chil-ler
chillier=chil-li-er
chilliest=chil-li-est
chillily=chil-li-ly
chilliness=chil-li-ness
chilly=chil-ly
chime=chime
chimp=chimp
chimer=chim-er
chimney=chim-ney
chimpanzee=chim-pan-zee
chin=chin
chinch=chinch
chine=chine
chink=chink
chintz=chintz
chintzier=chintz-i-er
chintziest=chintz-i-est
chintzy=chintz-y
chinchilla=chin-chil-la
chinese=chin-ese
chip=chip
chipmunk=chip-munk
chippendale=chip-pen-dale
chippendale=chip-pen-dale
chipper=chip-per
chipping=chip-ping
chippy=chip-py
chirp=chirp
chisel=chis-el
chiseled=chis-eled
chiselled=chis-elled
chiseler=chis-el-er
chiseling=chis-el-ing
chit=chit
chitchat=chit-chat
chitterlings=chit-ter-lings
chive=chive
chivalrous=chiv-al-rous
chivalry=chiv-al-ry
chianti=chi-an-ti
chianti=chi-an-ti
chicanery=chi-can-er-y
chicago=chi-ca-go
chicano=chi-ca-no
chicano=chi-ca-no
chichi=chi-chi
chignon=chi-gnon
chignons=chi-gnons
chill=chi-ll
chimeric=chi-mer-ic
chimerical=chi-mer-i-cal
chimera=chi-me-ra
china=chi-na
chinatown=chi-na-town
chinaware=chi-na-ware
chinese=chi-nese
chino=chi-no
chinook=chi-nook
chinook=chi-nook
chiropody=chi-rop-o-dy
chiromancy=chi-ro-man-cy
chiropractor=chi-ro-prac-tor
chitin=chi-tin
chitinous=chi-tin-ous
chlordane=chlor-dane
chloral=chlo-ral
chlorate=chlo-rate
chloride=chlo-ride
chlorine=chlo-rine
chlorinate=chlo-rin-ate
chlorite=chlo-rite
chloroform=chlo-ro-form
chlorophyll=chlo-ro-phyll
chock=chock
chocolate=choc-o-late
choctaw=choc-taw
choctaw=choc-taw
choice=choice
choicer=choic-er
choir=choir
choirmaster=choir-mas-ter
choke=choke
chokes=chokes
choker=chok-er
choking=chok-ing
choler=chol-er
cholera=chol-er-a
choleric=chol-er-ic
chomp=chomp
chon=chon
chondrite=chon-drite
chondrule=chon-drule
choose=choose
chooser=choos-er
choosier=choos-i-er
choosiest=choos-i-est
choosy=choos-y
chop=chop
chops=chops
chophouse=chop-house
chophouses=chop-hous-es
chopper=chop-per
choppers=chop-pers
chopping=chop-ping
choppier=chop-pi-er
choppiest=chop-pi-est
choppily=chop-pi-ly
choppiness=chop-pi-ness
choppy=chop-py
chopstick=chop-stick
chopsticks=chop-sticks
chopsticks=chop-sticks
chord=chord
chordal=chord-al
chore=chore
chordate=chor-date
chorister=chor-is-ter
chortle=chor-tle
chortler=chor-tler
chose=chose
chow=chow
chow=chow
chowder=chow-der
cholesterol=cho-les-ter-ol
choline=cho-line
choral=cho-ral
chorale=cho-rale
chorally=cho-ral-ly
chorea=cho-re-a
choreography=cho-re-og-ra-phy
choreograph=cho-re-o-graph
chorine=cho-rine
choroid=cho-roid
chorus=cho-rus
chorused=cho-rused
choruses=cho-rus-es
chorusing=cho-rus-ing
chosen=cho-sen
chosen=cho-sen
chrism=chrism
christ=christ
christlike=christ-like
christmas=christ-mas
christen=chris-ten
christendom=chris-ten-dom
christener=chris-ten-er
christian=chris-tian
christie=chris-tie
christine=chris-tine
christopher=chris-to-pher
christy=chris-ty
chrome=chrome
chroming=chrom-ing
chronic=chron-ic
chronicle=chron-i-cle
chronicler=chron-i-cler
chronicles=chron-i-cles
chronograph=chron-o-graph
chromatic=chro-mat-ic
chromatography=chro-ma-tog-ra-phy
chromic=chro-mic
chromium=chro-mi-um
chromo=chro-mo
chromosome=chro-mo-some
chromosphere=chro-mo-sphere
chronicity=chro-nic-i-ty
chronology=chro-nol-o-gy
chronometer=chro-nom-e-ter
chrysalis=chrys-a-lis
chrysler=chrys-ler
chrysolite=chrys-o-lite
chrysanthemum=chry-san-the-mum
chub=chub
chubbier=chub-bi-er
chubbiest=chub-bi-est
chubbiness=chub-bi-ness
chubby=chub-by
chuck=chuck
chuck=chuck
chuckhole=chuck-hole
chuckle=chuck-le
chuckled=chuck-led
chuckler=chuck-ler
chuckling=chuck-ling
chug=chug
chugging=chug-ging
chukka=chuk-ka
chukker=chuk-ker
chum=chum
chump=chump
chumming=chum-ming
chummier=chum-mi-er
chummiest=chum-mi-est
chummily=chum-mi-ly
chumminess=chum-mi-ness
chummy=chum-my
chunk=chunk
chunkier=chunk-i-er
chunkiest=chunk-i-est
chunkily=chunk-i-ly
chunkiness=chunk-i-ness
chunky=chunk-y
church=church
churchgoer=church-go-er
churchgoing=church-go-ing
churchill=church-ill
churchless=church-less
churchman=church-man
churchwoman=church-wom-an
churchwomen=church-wom-en
churchyard=church-yard
churl=churl
churlish=churl-ish
churlishly=churl-ish-ly
churn=churn
churner=churn-er
churning=churn-ing
chute=chute
chutzpa=chutz-pa
chutney=chut-ney
ciao=ciao
ciao=cia-o
cicatrix=cic-a-trix
cicatrices=cic-a-tri-ces
cicero=cic-e-ro
cicero=cic-e-ro
cicerone=cic-e-ro-ne
ciceronian=cic-e-ro-ni-an
cigarette=cig-a-rette
cigarillo=cig-a-ril-lo
cilia=cil-i-a
ciliary=cil-i-ar-y
ciliate=cil-i-ate
ciliated=cil-i-at-ed
cilium=cil-i-um
cinch=cinch
cincture=cinc-ture
cinctured=cinc-tured
cincturing=cinc-tur-ing
cinquefoil=cinque-foil
cinchona=cin-cho-na
cincinnati=cin-cin-nat-i
cinder=cin-der
cinderella=cin-der-el-la
cinderous=cin-der-ous
cindery=cin-der-y
cinema=cin-e-ma
cinematic=cin-e-mat-ic
cineraria=cin-e-rar-i-a
cinerarium=cin-e-rar-i-um
cinerary=cin-e-rar-y
cinnabar=cin-na-bar
cinnamon=cin-na-mon
cirque=cirque
circa=cir-ca
circadian=cir-ca-di-an
circe=cir-ce
circle=cir-cle
circler=cir-cler
circlet=cir-clet
circuit=cir-cuit
circuital=cir-cuit-al
circuitry=cir-cuit-ry
circumcise=cir-cum-cise
circumcision=cir-cum-ci-sion
circumference=cir-cum-fer-ence
circumferential=cir-cum-fer-en-tial
circumflex=cir-cum-flex
circumlocution=cir-cum-lo-cu-tion
circumpolar=cir-cum-po-lar
circumscribe=cir-cum-scribe
circumscription=cir-cum-scrip-tion
circumspect=cir-cum-spect
circumstance=cir-cum-stance
circumstantial=cir-cum-stan-tial
circumvent=cir-cum-vent
circumvention=cir-cum-ven-tion
circus=cir-cus
circuses=cir-cus-es
circuitous=cir-cu-i-tous
circuity=cir-cu-i-ty
circular=cir-cu-lar
circulate=cir-cu-late
circulated=cir-cu-lat-ed
circulator=cir-cu-la-tor
circulatory=cir-cu-la-to-ry
cirrhotic=cir-rhot-ic
cirrhosis=cir-rho-sis
cirrus=cir-rus
cislunar=cis-lu-nar
cistern=cis-tern
cite=cite
citadel=cit-a-del
cited=cit-ed
cities=cit-ies
citing=cit-ing
citified=cit-i-fied
citify=cit-i-fy
citifying=cit-i-fy-ing
citizen=cit-i-zen
citizenly=cit-i-zen-ly
citizenry=cit-i-zen-ry
citrate=cit-rate
citric=cit-ric
citron=cit-ron
citronella=cit-ron-el-la
citrus=cit-rus
citruses=cit-rus-es
city=cit-y
city=cit-y
cityscape=cit-y-scape
civet=civ-et
civic=civ-ic
civics=civ-ics
civil=civ-il
civilly=civ-il-ly
civilness=civ-il-ness
civilize=civ-i-lize
civilized=civ-i-lized
civilizer=civ-i-liz-er
civilizing=civ-i-liz-ing
civvies=civ-vies
cicada=ci-ca-da
cider=ci-der
cigar=ci-gar
cipher=ci-pher
citation=ci-ta-tion
civilian=ci-vil-ian
civility=ci-vil-i-ty
clabber=clab-ber
clack=clack
clacker=clack-er
clad=clad
cladding=clad-ding
claim=claim
claimant=claim-ant
claimer=claim-er
clairvoyant=clair-voy-ant
clam=clam
clamp=clamp
clambake=clam-bake
clamber=clam-ber
clamming=clam-ming
clammier=clam-mi-er
clammiest=clam-mi-est
clamminess=clam-mi-ness
clammy=clam-my
clamor=clam-or
clamorous=clam-or-ous
clamshell=clam-shell
clan=clan
clang=clang
clangor=clang-or
clangorous=clang-or-ous
clank=clank
clansman=clans-man
clanswoman=clans-wom-an
clanswomen=clans-wom-en
clandestine=clan-des-tine
clannish=clan-nish
clannishly=clan-nish-ly
clap=clap
clapboard=clap-board
clapper=clap-per
clapping=clap-ping
claptrap=clap-trap
claque=claque
clarence=clar-ence
clarence=clar-ence
claret=clar-et
clarified=clar-i-fied
clarifier=clar-i-fi-er
clarify=clar-i-fy
clarifying=clar-i-fy-ing
clarinet=clar-i-net
clarion=clar-i-on
clarion=clar-i-on
clarity=clar-i-ty
clash=clash
clasp=clasp
clasper=clasp-er
clasping=clasp-ing
class=class
classier=class-i-er
classiest=class-i-est
classless=class-less
classmate=class-mate
classroom=class-room
classy=class-y
classes=clas-ses
classic=clas-sic
classics=clas-sics
classical=clas-si-cal
classicism=clas-si-cism
classicist=clas-si-cist
classified=clas-si-fied
classification=clas-si-fi-ca-tion
classificatory=clas-si-fi-ca-to-ry
classify=clas-si-fy
clatter=clat-ter
clattery=clat-ter-y
clause=clause
clausal=claus-al
claustrophobic=claus-tro-pho-bic
claustrophobia=claus-tro-pho-bi-a
clavier=clav-ier
clavichord=clav-i-chord
clavicle=clav-i-cle
claw=claw
clay=clay
clay=clay
clayey=clay-ey
clayish=clay-ish
claymore=clay-more
clavicular=cla-vic-u-lar
clavier=cla-vier
clavierist=cla-vier-ist
clean=clean
cleanse=cleanse
cleanser=cleans-er
cleansing=cleans-ing
cleaner=clean-er
cleaning=clean-ing
cleanlier=clean-li-er
cleanliest=clean-li-est
cleanly=clean-ly
cleanness=clean-ness
cleanup=clean-up
clear=clear
clearance=clear-ance
clearable=clear-a-ble
clearer=clear-er
clearheaded=clear-head-ed
clearing=clear-ing
clearly=clear-ly
clearness=clear-ness
clearwater=clear-wa-ter
cleat=cleat
cleave=cleave
cleavage=cleav-age
cleaver=cleav-er
cleavers=cleav-ers
cleaving=cleav-ing
clef=clef
cleft=cleft
clematis=clem-a-tis
clement=clem-ent
clement=clem-ent
clemently=clem-ent-ly
clemency=clem-en-cy
clemency=clem-en-cy
clench=clench
clerestory=clere-sto-ry
clerk=clerk
clerkship=clerk-ship
clergy=cler-gy
clergyman=cler-gy-man
cleric=cler-ic
clerical=cler-i-cal
cleveland=cleve-land
clever=clev-er
cleverly=clev-er-ly
cleverness=clev-er-ness
clevis=clev-is
clew=clew
click=click
clicker=click-er
cliff=cliff
cliff=cliff
clifton=clif-ton
climb=climb
climbable=climb-a-ble
climber=climb-er
climbing=climb-ing
clime=clime
clinch=clinch
clincher=clinch-er
cling=cling
clinger=cling-er
clinging=cling-ing
clingier=cling-i-er
clingiest=cling-i-est
clingstone=cling-stone
clingy=cling-y
clink=clink
clinker=clink-er
clinic=clin-ic
clinical=clin-i-cal
clinically=clin-i-cal-ly
clip=clip
clipped=clipped
clips=clips
clipboard=clip-board
clipper=clip-per
clippers=clip-pers
clipping=clip-ping
clipsheet=clip-sheet
clique=clique
clitoral=clit-o-ral
clitoris=clit-o-ris
cliche=cli-che
client=cli-ent
clientele=cli-en-tele
climactic=cli-mac-tic
climate=cli-mate
climatal=cli-mat-al
climatic=cli-mat-ic
climatical=cli-mat-i-cal
climax=cli-max
climatology=cli-ma-tol-o-gy
clinician=cli-ni-cian
cliquey=cli-quey
cliquish=cli-quish
cliquishly=cli-quish-ly
cliquy=cli-quy
cloak=cloak
cloakroom=cloak-room
clobber=clob-ber
clock=clock
clocker=clock-er
clockwise=clock-wise
clockwork=clock-work
clod=clod
cloddish=clod-dish
cloddy=clod-dy
clodhopper=clod-hop-per
clog=clog
clogging=clog-ging
cloggy=clog-gy
cloister=clois-ter
cloistered=clois-tered
cloistral=clois-tral
clone=clone
clop=clop
close=close
closed=closed
closeable=close-a-ble
closely=close-ly
closeness=close-ness
closeout=close-out
closable=clos-a-ble
closer=clos-er
closest=clos-est
closet=clos-et
closing=clos-ing
clot=clot
cloth=cloth
clothe=clothe
clothes=clothes
clotheshorse=clothes-horse
clothesline=clothes-line
clothespin=clothes-pin
clothespress=clothes-press
clothier=cloth-ier
clothing=cloth-ing
clotted=clot-ted
clotting=clot-ting
cloud=cloud
clouds=clouds
cloudburst=cloud-burst
clouded=cloud-ed
cloudier=cloud-i-er
cloudiest=cloud-i-est
cloudiness=cloud-i-ness
cloudless=cloud-less
cloudlet=cloud-let
cloudlike=cloud-like
cloudy=cloud-y
clout=clout
clove=clove
clown=clown
clownish=clown-ish
clownishly=clown-ish-ly
cloy=cloy
cloying=cloy-ing
closure=clo-sure
clothier=clo-thi-er
cloture=clo-ture
cloven=clo-ven
clover=clo-ver
clover=clo-ver
cloverleaf=clo-ver-leaf
club=club
clubbing=club-bing
clubfoot=club-foot
clubfooted=club-foot-ed
clubhouse=club-house
clubhouses=club-hous-es
cluck=cluck
clue=clue
clump=clump
clumpy=clump-y
clumsier=clum-si-er
clumsiest=clum-si-est
clumsily=clum-si-ly
clumsiness=clum-si-ness
clumsy=clum-sy
clung=clung
cluster=clus-ter
clustered=clus-tered
clutch=clutch
clutter=clut-ter
cluing=clu-ing
coach=coach
coacher=coach-er
coachman=coach-man
coal=coal
coarse=coarse
coarsely=coarse-ly
coarseness=coarse-ness
coarsen=coars-en
coarser=coars-er
coarsest=coars-est
coast=coast
coastal=coast-al
coaster=coast-er
coastline=coast-line
coat=coat
coated=coat-ed
coating=coat-ing
coattail=coat-tail
coax=coax
coaxer=coax-er
coaxingly=coax-ing-ly
cob=cob
cobble=cob-ble
cobbler=cob-bler
cobblers=cob-blers
cobbles=cob-bles
cobblestone=cob-ble-stone
cobweb=cob-web
cobwebs=cob-webs
cochineal=coch-i-neal
cochlea=coch-le-a
cochlear=coch-le-ar
cock=cock
cockscomb=cocks-comb
cockade=cock-ade
cockatoo=cock-a-too
cockatrice=cock-a-trice
cockcrow=cock-crow
cocker=cock-er
cockerel=cock-er-el
cockeye=cock-eye
cockeyed=cock-eyed
cockfight=cock-fight
cockhorse=cock-horse
cockier=cock-i-er
cockiest=cock-i-est
cockily=cock-i-ly
cockiness=cock-i-ness
cockle=cock-le
cockleshell=cock-le-shell
cockney=cock-ney
cockpit=cock-pit
cockroach=cock-roach
cocksure=cock-sure
cocktail=cock-tail
cocky=cock-y
cocci=coc-ci
coccus=coc-cus
coccygeal=coc-cyg-e-al
coccyx=coc-cyx
coccyges=coc-cy-ges
cod=cod
cod=cod
cod=cod
code=code
codger=codg-er
coddle=cod-dle
coddler=cod-dler
coded=cod-ed
codfish=cod-fish
codfishes=cod-fish-es
coding=cod-ing
codicil=cod-i-cil
codified=cod-i-fied
codifier=cod-i-fi-er
codify=cod-i-fy
codifying=cod-i-fy-ing
codling=cod-ling
codpiece=cod-piece
coffee=cof-fee
coffeecake=cof-fee-cake
coffeepot=cof-fee-pot
coffer=cof-fer
cofferdam=cof-fer-dam
coffin=cof-fin
coffin=cof-fin
cog=cog
cogitate=cog-i-tate
cogitated=cog-i-tat-ed
cogitation=cog-i-ta-tion
cogitative=cog-i-ta-tive
cogitator=cog-i-ta-tor
cognac=cog-nac
cognate=cog-nate
cognition=cog-ni-tion
cognitive=cog-ni-tive
cognizance=cog-ni-zance
cognizant=cog-ni-zant
cognizable=cog-ni-za-ble
cognomina=cog-nom-i-na
cognomen=cog-no-men
cognomens=cog-no-mens
cogwheel=cog-wheel
coif=coif
coiffeur=coif-feur
coiffure=coif-fure
coil=coil
coin=coin
coinage=coin-age
coiner=coin-er
coke=coke
coke=coke
col=col
col=col
cold=cold
cold=cold
coldly=cold-ly
coldness=cold-ness
coleslaw=cole-slaw
coll=coll
colloq=colloq
colonel=colo-nel
colonelcy=colo-nel-cy
colt=colt
colt=colt
coltish=colt-ish
colander=col-an-der
colic=col-ic
colicky=col-ick-y
coliseum=col-i-se-um
collaborate=col-lab-o-rate
collage=col-lage
collapse=col-lapse
collapsed=col-lapsed
collapsing=col-laps-ing
collapsible=col-laps-i-ble
collar=col-lar
collard=col-lard
collarbone=col-lar-bone
collarless=col-lar-less
collate=col-late
collated=col-lat-ed
collateral=col-lat-er-al
collating=col-lat-ing
collagen=col-la-gen
collation=col-la-tion
collator=col-la-tor
colleague=col-league
collect=col-lect
collected=col-lect-ed
collectible=col-lect-i-ble
collection=col-lec-tion
collective=col-lec-tive
collectivism=col-lec-tiv-ism
collector=col-lec-tor
colleen=col-leen
colleen=col-leen
college=col-lege
collegian=col-le-gian
collegiate=col-le-giate
collegia=col-le-gi-a
collegial=col-le-gi-al
collegian=col-le-gi-an
collegiate=col-le-gi-ate
collegium=col-le-gi-um
collide=col-lide
collided=col-lid-ed
colliding=col-lid-ing
collie=col-lie
collier=col-lier
collier=col-lier
collieries=col-lier-ies
colliery=col-lier-y
collins=col-lins
collins=col-lins
collinear=col-lin-e-ar
collier=col-li-er
collimate=col-li-mate
collision=col-li-sion
colloid=col-loid
colloidal=col-loi-dal
collocate=col-lo-cate
collocated=col-lo-cat-ed
collocation=col-lo-ca-tion
collodion=col-lo-di-on
colloquia=col-lo-qui-a
colloquial=col-lo-qui-al
colloquium=col-lo-qui-um
colloquy=col-lo-quy
collude=col-lude
colluded=col-lud-ed
colluding=col-lud-ing
collusion=col-lu-sion
collusive=col-lu-sive
colluvium=col-lu-vi-um
colonnade=col-on-nade
colonnaded=col-on-nad-ed
color=col-or
colored=col-ored
colored=col-ored
colors=col-ors
colorant=col-or-ant
coloration=col-or-a-tion
colorcast=col-or-cast
colored=col-or-ed
colorfast=col-or-fast
colorful=col-or-ful
colorfully=col-or-ful-ly
coloring=col-or-ing
colorless=col-or-less
colosseum=col-os-se-um
colosseum=col-os-se-um
colonies=col-o-nies
colonist=col-o-nist
colonize=col-o-nize
colonized=col-o-nized
colonizer=col-o-niz-er
colony=col-o-ny
colophon=col-o-phon
colophon=col-o-phon
colorado=col-o-rad-o
colorado=col-o-rad-o
colorado=col-o-ra-do
coloratura=col-o-ra-tu-ra
colporteur=col-por-teur
column=col-umn
columned=col-umned
columnist=col-umn-ist
columbine=col-um-bine
columbine=col-um-bine
comb=comb
comber=comb-er
combings=comb-ings
come=come
comeback=come-back
comedown=come-down
comelier=come-li-er
comeliest=come-li-est
comeliness=come-li-ness
comely=come-ly
compton=comp-ton
comptroller=comp-trol-ler
comatose=com-a-tose
combat=com-bat
combatant=com-bat-ant
combated=com-bat-ed
combating=com-bat-ing
combative=com-bat-ive
combatted=com-bat-ted
combatting=com-bat-ting
combine=com-bine
combined=com-bined
combiner=com-bin-er
combining=com-bin-ing
combinatorial=com-bi-na-to-ri-al
combo=com-bo
combustion=com-bus-tion
combustive=com-bus-tive
combustible=com-bus-ti-ble
comer=com-er
comet=com-et
cometary=com-et-ar-y
comedo=com-e-do
comedos=com-e-dos
comedones=com-e-do-nes
comedy=com-e-dy
comfit=com-fit
comfier=com-fi-er
comfiest=com-fi-est
comfort=com-fort
comfort=com-fort
comfortable=com-fort-a-ble
comforter=com-fort-er
comforter=com-fort-er
comfy=com-fy
comic=com-ic
coming=com-ing
comical=com-i-cal
comicality=com-i-cal-i-ty
comically=com-i-cal-ly
comity=com-i-ty
comma=com-ma
command=com-mand
commander=com-mand-er
commanding=com-mand-ing
commandment=com-mand-ment
commandant=com-man-dant
commandeer=com-man-deer
commando=com-man-do
commemorate=com-mem-o-rate
commence=com-mence
commenced=com-menced
commencing=com-menc-ing
commend=com-mend
commendatory=com-mend-a-to-ry
comment=com-ment
commendation=com-men-da-tion
commensurate=com-men-su-rate
commensurable=com-men-su-ra-ble
commentary=com-men-tar-y
commentator=com-men-ta-tor
commerce=com-merce
commerce=com-merce
commercial=com-mer-cial
commingle=com-min-gle
commiserate=com-mis-er-ate
commissar=com-mis-sar
commissariat=com-mis-sar-i-at
commissary=com-mis-sar-y
commission=com-mis-sion
commit=com-mit
commitment=com-mit-ment
committal=com-mit-tal
committable=com-mit-ta-ble
committed=com-mit-ted
committee=com-mit-tee
committeeman=com-mit-tee-man
committeewoman=com-mit-tee-wom-an
committeewomen=com-mit-tee-wom-en
committing=com-mit-ting
comminute=com-mi-nute
commode=com-mode
commodity=com-mod-i-ty
common=com-mon
commons=com-mons
commons=com-mons
commonality=com-mon-al-i-ty
commonalty=com-mon-al-ty
commoner=com-mon-er
commonly=com-mon-ly
commonness=com-mon-ness
commonplace=com-mon-place
commonweal=com-mon-weal
commonwealth=com-mon-wealth
commonwealth=com-mon-wealth
commodious=com-mo-di-ous
commodore=com-mo-dore
commotion=com-mo-tion
commune=com-mune
commune=com-mune
communed=com-muned
communing=com-mun-ing
communion=com-mun-ion
communion=com-mun-ion
communism=com-mun-ism
communist=com-mun-ist
commute=com-mute
commuted=com-mut-ed
commuter=com-mut-er
commuting=com-mut-ing
communal=com-mu-nal
communally=com-mu-nal-ly
communicant=com-mu-ni-cant
communicate=com-mu-ni-cate
communicable=com-mu-ni-ca-ble
community=com-mu-ni-ty
commutator=com-mu-ta-tor
compact=com-pact
compactly=com-pact-ly
companion=com-pan-ion
companionway=com-pan-ion-way
compare=com-pare
compared=com-pared
compartment=com-part-ment
comparative=com-par-a-tive
comparer=com-par-er
comparing=com-par-ing
comparison=com-par-i-son
compass=com-pass
compassion=com-pas-sion
compassionate=com-pas-sion-ate
compatible=com-pat-i-ble
compatibly=com-pat-i-bly
compatriot=com-pat-ri-ot
company=com-pa-ny
comparable=com-pa-ra-ble
comparably=com-pa-ra-bly
compatriot=com-pa-tri-ot
compeer=com-peer
compel=com-pel
compelled=com-pelled
compellable=com-pel-la-ble
compeller=com-pel-ler
compelling=com-pel-ling
compendia=com-pen-di-a
compendium=com-pen-di-um
compensate=com-pen-sate
compensable=com-pen-sa-ble
compensation=com-pen-sa-tion
compensatory=com-pen-sa-to-ry
compete=com-pete
competed=com-pet-ed
competing=com-pet-ing
competitive=com-pet-i-tive
competitor=com-pet-i-tor
competence=com-pe-tence
competent=com-pe-tent
competency=com-pe-ten-cy
competition=com-pe-ti-tion
compile=com-pile
compiled=com-piled
compiler=com-pil-er
compiling=com-pil-ing
compilation=com-pi-la-tion
complain=com-plain
complaint=com-plaint
complainant=com-plain-ant
complainer=com-plain-er
complaisant=com-plai-sant
complacent=com-pla-cent
complected=com-plect-ed
complete=com-plete
completely=com-plete-ly
completed=com-plet-ed
completing=com-plet-ing
complex=com-plex
complexion=com-plex-ion
complexity=com-plex-i-ty
complement=com-ple-ment
complementary=com-ple-men-ta-ry
complementation=com-ple-men-ta-tion
completion=com-ple-tion
complicity=com-plic-i-ty
complied=com-plied
compline=com-pline
compliance=com-pli-ance
compliant=com-pli-ant
complicate=com-pli-cate
compliment=com-pli-ment
complimentary=com-pli-men-ta-ry
comply=com-ply
complying=com-ply-ing
comport=com-port
comportment=com-port-ment
compose=com-pose
composed=com-posed
compost=com-post
composedly=com-pos-ed-ly
composer=com-pos-er
composing=com-pos-ing
composite=com-pos-ite
compositor=com-pos-i-tor
compote=com-pote
compound=com-pound
compounder=com-pound-er
component=com-po-nent
composite=com-po-site
composition=com-po-si-tion
composure=com-po-sure
compress=com-press
compressed=com-pressed
compressible=com-press-i-ble
compression=com-pres-sion
compressive=com-pres-sive
compressor=com-pres-sor
comprehend=com-pre-hend
comprehension=com-pre-hen-sion
comprehensive=com-pre-hen-sive
comprehensible=com-pre-hen-si-ble
comprise=com-prise
comprised=com-prised
comprising=com-pris-ing
compromise=com-pro-mise
compulsion=com-pul-sion
compulsive=com-pul-sive
compulsory=com-pul-so-ry
compute=com-pute
computable=com-put-a-ble
computed=com-put-ed
computer=com-put-er
computing=com-put-ing
computation=com-pu-ta-tion
comrade=com-rade
con=con
concertina=con-cer-ti-na
conch=conch
cone=cone
conk=conk
cons=cons
cons=cons
conservation=conserva-tion
concatenate=con-cat-e-nate
concatenation=con-cat-e-na-tion
concave=con-cave
concavity=con-cav-i-ty
conceal=con-ceal
concealer=con-ceal-er
concede=con-cede
conceded=con-ced-ed
conceding=con-ced-ing
conceit=con-ceit
conceited=con-ceit-ed
conceive=con-ceive
conceived=con-ceived
conceiver=con-ceiv-er
conceiving=con-ceiv-ing
concentrate=con-cen-trate
concentric=con-cen-tric
concept=con-cept
conception=con-cep-tion
conceptual=con-cep-tu-al
concern=con-cern
concerned=con-cerned
concerning=con-cern-ing
concert=con-cert
concerted=con-cert-ed
concertize=con-cert-ize
concertmaster=con-cert-mas-ter
concertize=con-cer-tize
concertina=con-cer-ti-na
concerto=con-cer-to
concession=con-ces-sion
concessionaire=con-ces-sion-aire
concessive=con-ces-sive
concierge=con-cierge
conciliatory=con-cil-ia-to-ry
conciliate=con-cil-i-ate
conciliatory=con-cil-i-a-to-ry
concise=con-cise
concisely=con-cise-ly
concierge=con-ci-erge
concision=con-ci-sion
conclave=con-clave
conclude=con-clude
concluded=con-clud-ed
concluder=con-clud-er
concluding=con-clud-ing
conclusion=con-clu-sion
conclusive=con-clu-sive
concoct=con-coct
concoction=con-coc-tion
concomitant=con-com-i-tant
concord=con-cord
concord=con-cord
concordance=con-cord-ance
concordant=con-cord-ant
concordat=con-cor-dat
concourse=con-course
concrescence=con-cres-cence
concrete=con-crete
concretely=con-crete-ly
concreted=con-cret-ed
concreting=con-cret-ing
concretion=con-cre-tion
concur=con-cur
concurred=con-curred
concurrence=con-cur-rence
concurrent=con-cur-rent
concurring=con-cur-ring
concussion=con-cus-sion
concubine=con-cu-bine
concupiscence=con-cu-pis-cence
condemn=con-demn
condemner=con-demn-er
condemnatory=con-dem-na-to-ry
condense=con-dense
condensed=con-densed
condenser=con-dens-er
condensing=con-dens-ing
condensate=con-den-sate
condensible=con-den-si-ble
condescend=con-de-scend
condescension=con-de-scen-sion
condign=con-dign
condignly=con-dign-ly
condiment=con-di-ment
condition=con-di-tion
condole=con-dole
condoled=con-doled
condoler=con-dol-er
condoling=con-dol-ing
condom=con-dom
condone=con-done
condoned=con-doned
condonable=con-don-a-ble
condoner=con-don-er
condoning=con-don-ing
condor=con-dor
condolence=con-do-lence
conduce=con-duce
conduced=con-duced
conduct=con-duct
conductance=con-duct-ance
conducing=con-duc-ing
conduction=con-duc-tion
conductive=con-duc-tive
conductor=con-duc-tor
conduit=con-duit
conducive=con-du-cive
condyle=con-dyle
conestoga=con-es-to-ga
confab=con-fab
confabbed=con-fabbed
confabbing=con-fab-bing
confabulate=con-fab-u-late
confection=con-fec-tion
confectionery=con-fec-tion-er-y
confederate=con-fed-er-ate
confederate=con-fed-er-ate
confederacy=con-fed-er-a-cy
confederacy=con-fed-er-a-cy
confederation=con-fed-er-a-tion
confederation=con-fed-er-a-tion
confer=con-fer
conferred=con-ferred
conferee=con-fer-ee
conference=con-fer-ence
conferment=con-fer-ment
conferrable=con-fer-ra-ble
conferrer=con-fer-rer
conferring=con-fer-ring
confess=con-fess
confession=con-fes-sion
confessor=con-fes-sor
confetti=con-fet-ti
confide=con-fide
confided=con-fid-ed
confider=con-fid-er
confiding=con-fid-ing
configure=con-fig-ure
configuration=con-fig-u-ra-tion
confine=con-fine
confined=con-fined
confiner=con-fin-er
confining=con-fin-ing
confirm=con-firm
confirmed=con-firmed
confirmatory=con-firm-a-to-ry
confirmation=con-fir-ma-tion
confiscate=con-fis-cate
confiscatory=con-fis-ca-to-ry
confidant=con-fi-dant
confidante=con-fi-dante
confidence=con-fi-dence
confident=con-fi-dent
confidential=con-fi-den-tial
conflict=con-flict
confluence=con-flu-ence
confluent=con-flu-ent
conform=con-form
conformance=con-form-ance
conformer=con-form-er
conformism=con-form-ism
conformist=con-form-ist
conformity=con-form-i-ty
conformal=con-for-mal
conformation=con-for-ma-tion
confound=con-found
confounded=con-found-ed
confounder=con-found-er
confocal=con-fo-cal
confraternity=con-fra-ter-ni-ty
confrere=con-frere
confront=con-front
confrontation=con-fron-ta-tion
confuse=con-fuse
confused=con-fused
confusedly=con-fus-ed-ly
confusing=con-fus-ing
confute=con-fute
confuted=con-fut-ed
confuting=con-fut-ing
confucian=con-fu-cian
confucianism=con-fu-cian-ism
confusion=con-fu-sion
conga=con-ga
congeal=con-geal
congenial=con-gen-ial
congenital=con-gen-i-tal
conger=con-ger
congest=con-gest
congestion=con-ges-tion
congestive=con-ges-tive
congener=con-ge-ner
congeneric=con-ge-ner-ic
congeries=con-ge-ries
conglomerate=con-glom-er-ate
congolese=con-go-lese
congratulate=con-grat-u-late
congratulatory=con-grat-u-la-to-ry
congress=con-gress
congress=con-gress
congressman=con-gress-man
congressman=con-gress-man
congresswoman=con-gress-wom-an
congresswoman=con-gress-wom-an
congresswomen=con-gress-wom-en
congressional=con-gres-sion-al
congregant=con-gre-gant
congregate=con-gre-gate
congregation=con-gre-ga-tion
congruence=con-gru-ence
congruent=con-gru-ent
congruency=con-gru-en-cy
congruity=con-gru-i-ty
congruous=con-gru-ous
conic=con-ic
conical=con-i-cal
conically=con-i-cal-ly
conjecture=con-jec-ture
conjectural=con-jec-tur-al
conjoin=con-join
conjoined=con-joined
conjoint=con-joint
conjointly=con-joint-ly
conjunct=con-junct
conjunctive=con-junc-tive
conjuncture=con-junc-ture
conjure=con-jure
conjured=con-jured
conjurer=con-jur-er
conjuring=con-jur-ing
conjuror=con-jur-or
conjugal=con-ju-gal
conjugally=con-ju-gal-ly
conjugate=con-ju-gate
conjugated=con-ju-gat-ed
conjugator=con-ju-ga-tor
conjuror=con-ju-ror
connect=con-nect
connected=con-nect-ed
connecticut=con-nect-i-cut
connection=con-nec-tion
connective=con-nec-tive
connector=con-nec-tor
connie=con-nie
conning=con-ning
conniption=con-nip-tion
connive=con-nive
connived=con-nived
connivance=con-niv-ance
conniver=con-niv-er
conniving=con-niv-ing
connoisseur=con-nois-seur
connote=con-note
connoted=con-not-ed
connoting=con-not-ing
connotation=con-no-ta-tion
connotative=con-no-ta-tive
connubial=con-nu-bi-al
conquer=con-quer
conqueror=con-quer-or
conqueror=con-quer-or
conquest=con-quest
conquest=con-quest
conquistador=con-quis-ta-dor
consanguine=con-san-guine
consanguineous=con-san-guin-e-ous
consanguinity=con-san-guin-i-ty
conscience=con-science
conscious=con-scious
conscientious=con-sci-en-tious
conscript=con-script
conscription=con-scrip-tion
consecutive=con-sec-u-tive
consent=con-sent
consensus=con-sen-sus
conserve=con-serve
conservatism=con-serv-a-tism
conservatism=con-serv-a-tism
conservative=con-serv-a-tive
conservative=con-serv-a-tive
conservatory=con-serv-a-tory
conservatory=con-serv-a-to-ry
conservation=con-ser-va-tion
conservator=con-ser-va-tor
consecrate=con-se-crate
consequence=con-se-quence
consequent=con-se-quent
consequential=con-se-quen-tial
consider=con-sid-er
considered=con-sid-ered
considerate=con-sid-er-ate
considerable=con-sid-er-a-ble
consideration=con-sid-er-a-tion
consign=con-sign
consignee=con-sign-ee
consignor=con-sign-or
consist=con-sist
consistent=con-sist-ent
consistency=con-sist-en-cy
consistory=con-sis-to-ry
console=con-sole
consoled=con-soled
consoler=con-sol-er
consoling=con-sol-ing
consolidate=con-sol-i-date
consort=con-sort
consortia=con-sor-ti-a
consortium=con-sor-ti-um
consolation=con-so-la-tion
consonance=con-so-nance
consonant=con-so-nant
consonantal=con-so-nan-tal
conspectus=con-spec-tus
conspicuous=con-spic-u-ous
conspire=con-spire
conspired=con-spired
conspiracy=con-spir-a-cy
conspirator=con-spir-a-tor
conspiratorial=con-spir-a-to-ri-al
conspiring=con-spir-ing
constance=con-stance
constant=con-stant
constant=con-stant
constantly=con-stant-ly
constancy=con-stan-cy
constable=con-sta-ble
constable=con-sta-ble
consternate=con-ster-nate
constituent=con-stit-u-ent
constituency=con-stit-u-en-cy
constipate=con-sti-pate
constitute=con-sti-tute
constituting=con-sti-tut-ing
constitution=con-sti-tu-tion
constitutional=con-sti-tu-tion-al
constitutionally=con-sti-tu-tion-al-ly
constrain=con-strain
constraint=con-straint
constrict=con-strict
constrictor=con-stric-tor
construct=con-struct
constructible=con-struct-i-ble
construction=con-struc-tion
constructor=con-struc-tor
construe=con-strue
construed=con-strued
construer=con-stru-er
construing=con-stru-ing
consul=con-sul
consult=con-sult
consultant=con-sult-ant
consultative=con-sult-a-tive
consulting=con-sult-ing
consulship=con-sul-ship
consultation=con-sul-ta-tion
consultative=con-sul-ta-tive
consume=con-sume
consumed=con-sumed
consumption=con-sump-tion
consumptive=con-sump-tive
consumable=con-sum-a-ble
consumer=con-sum-er
consuming=con-sum-ing
consummate=con-sum-mate
consular=con-su-lar
consulate=con-su-late
contact=con-tact
contain=con-tain
contained=con-tained
container=con-tain-er
contaminant=con-tam-i-nant
contaminate=con-tam-i-nate
contagion=con-ta-gion
contagious=con-ta-gious
contemn=con-temn
contempt=con-tempt
contemptible=con-tempt-i-ble
contemptuous=con-temp-tu-ous
contemplate=con-tem-plate
contemporary=con-tem-po-rar-y
contemporaneous=con-tem-po-ra-ne-ous
contend=con-tend
content=con-tent
contented=con-tent-ed
contently=con-tent-ly
contention=con-ten-tion
contentious=con-ten-tious
contest=con-test
contestant=con-test-ant
context=con-text
contextual=con-tex-tu-al
contiguous=con-tig-u-ous
contingent=con-tin-gent
continue=con-tin-ue
continued=con-tin-ued
continua=con-tin-u-a
continual=con-tin-u-al
continuance=con-tin-u-ance
continuant=con-tin-u-ant
continuation=con-tin-u-a-tion
continuer=con-tin-u-er
continuing=con-tin-u-ing
continuo=con-tin-u-o
continuous=con-tin-u-ous
continuum=con-tin-u-um
contiguity=con-ti-gu-i-ty
continence=con-ti-nence
continent=con-ti-nent
continent=con-ti-nent
continental=con-ti-nen-tal
continental=con-ti-nen-tal
continuity=con-ti-nu-i-ty
contort=con-tort
contorted=con-tort-ed
contortion=con-tor-tion
contortive=con-tor-tive
contour=con-tour
contra=con-tra
contract=con-tract
contracted=con-tract-ed
contractile=con-trac-tile
contractor=con-trac-tor
contractual=con-trac-tu-al
contrail=con-trail
contralto=con-tral-to
contraption=con-trap-tion
contrast=con-trast
contraband=con-tra-band
contrabass=con-tra-bass
contraception=con-tra-cep-tion
contraceptive=con-tra-cep-tive
contradict=con-tra-dict
contradictory=con-tra-dic-to-ry
contrariety=con-tra-ri-e-ty
contrarily=con-tra-ri-ly
contrary=con-tra-ry
contravene=con-tra-vene
contravention=con-tra-ven-tion
contretemps=con-tre-temps
contribute=con-trib-ute
contributor=con-trib-u-tor
contributory=con-trib-u-to-ry
contrite=con-trite
contritely=con-trite-ly
contrive=con-trive
contrived=con-trived
contrivance=con-triv-ance
contriver=con-triv-er
contriving=con-triv-ing
contribute=con-tri-bute
contribution=con-tri-bu-tion
contrition=con-tri-tion
control=con-trol
controlled=con-trolled
controllable=con-trol-la-ble
controller=con-trol-ler
controlling=con-trol-ling
controvert=con-tro-vert
controvertible=con-tro-vert-i-ble
controversial=con-tro-ver-sial
controversy=con-tro-ver-sy
contumacious=con-tu-ma-cious
contumacy=con-tu-ma-cy
contumely=con-tu-me-ly
contusion=con-tu-sion
convalesce=con-va-lesce
convalescent=con-va-les-cent
convect=con-vect
convection=con-vec-tion
convective=con-vec-tive
convene=con-vene
convened=con-vened
convent=con-vent
convener=con-ven-er
convenient=con-ven-ient
convening=con-ven-ing
convenient=con-ven-i-ent
convention=con-ven-tion
conventicle=con-ven-ti-cle
conventual=con-ven-tu-al
converge=con-verge
converged=con-verged
converging=con-verg-ing
converse=con-verse
converse=con-verse
conversed=con-versed
conversely=con-verse-ly
conversing=con-vers-ing
convert=con-vert
converted=con-vert-ed
converter=con-vert-er
convertible=con-vert-i-ble
convergent=con-ver-gent
conversant=con-ver-sant
conversation=con-ver-sa-tion
conversion=con-ver-sion
convertor=con-ver-tor
convex=con-vex
convexity=con-vex-i-ty
convey=con-vey
conveyance=con-vey-ance
conveyable=con-vey-a-ble
conveyer=con-vey-er
conveyor=con-vey-or
convict=con-vict
conviction=con-vic-tion
convince=con-vince
convinced=con-vinced
convincer=con-vinc-er
convincing=con-vinc-ing
convivial=con-viv-i-al
convoke=con-voke
convoked=con-voked
convoking=con-vok-ing
convoy=con-voy
convolute=con-vo-lute
convoluted=con-vo-lut-ed
convolution=con-vo-lu-tion
convulse=con-vulse
convulsed=con-vulsed
convulsing=con-vuls-ing
convulsion=con-vul-sion
convulsive=con-vul-sive
coo=coo
cook=cook
cook=cook
cookbook=cook-book
cooker=cook-er
cookery=cook-er-y
cookery=cook-e-ry
cookie=cook-ie
cookie=cook-ie
cookies=cook-ies
cooking=cook-ing
cookout=cook-out
cookstove=cook-stove
cool=cool
coolant=cool-ant
cooler=cool-er
coolidge=cool-idge
coolie=cool-ie
coolly=cool-ly
coolness=cool-ness
coon=coon
coonhound=coon-hound
coonskin=coon-skin
coop=coop
coop=coop
cooper=coop-er
cooperage=coop-er-age
coos=coos
coot=coot
cootie=coot-ie
cooties=coot-ies
cooing=coo-ing
coolidge=coo-lidge
coolie=coo-lie
cooper=coo-per
cop=cop
cope=cope
copse=copse
copied=cop-ied
copies=cop-ies
coping=cop-ing
copier=cop-i-er
copper=cop-per
copperas=cop-per-as
copperhead=cop-per-head
coppery=cop-per-y
copping=cop-ping
copra=cop-ra
copter=cop-ter
copula=cop-u-la
copular=cop-u-lar
copulate=cop-u-late
copulated=cop-u-lat-ed
copulating=cop-u-lat-ing
copulation=cop-u-la-tion
copulative=cop-u-la-tive
copy=cop-y
copybook=cop-y-book
copyboy=cop-y-boy
copycat=cop-y-cat
copyholder=cop-y-hold-er
copying=cop-y-ing
copyist=cop-y-ist
copyreader=cop-y-read-er
copyright=cop-y-right
copywriter=cop-y-writ-er
cord=cord
cords=cords
cordage=cord-age
corded=cord-ed
corder=cord-er
cording=cord-ing
cordite=cord-ite
cordless=cord-less
core=core
core=core
cork=cork
cork=cork
corked=corked
corker=cork-er
corking=cork-ing
corkier=cork-i-er
corkiest=cork-i-est
corkscrew=cork-screw
corky=cork-y
corn=corn
corned=corned
cornball=corn-ball
corncob=corn-cob
corncrib=corn-crib
cornfield=corn-field
cornflower=corn-flow-er
cornier=corn-i-er
corniest=corn-i-est
cornstalk=corn-stalk
cornstalk=corn-stalk
cornstarch=corn-starch
corny=corn-y
corp=corp
corps=corps
corpse=corpse
corpsman=corps-man
correl=correl
coral=cor-al
coral=cor-al
coracle=cor-a-cle
corbel=cor-bel
cordial=cor-dial
cordiality=cor-dial-i-ty
cordially=cor-dial-ly
cordillera=cor-dil-le-ra
cordial=cor-di-al
cordiality=cor-di-al-i-ty
cordon=cor-don
cordoba=cor-do-ba
cordoba=cor-do-ba
cordovan=cor-do-van
cordovan=cor-do-van
corduroy=cor-du-roy
corduroys=cor-du-roys
corer=cor-er
coring=cor-ing
corker=cor-ker
cormorant=cor-mo-rant
cornell=cor-nell
corner=cor-ner
corner=cor-ner
cornered=cor-nered
cornerstone=cor-ner-stone
cornet=cor-net
cornetist=cor-net-ist
cornea=cor-ne-a
corneal=cor-ne-al
corneous=cor-ne-ous
cornice=cor-nice
corning=cor-ning
cornish=cor-nish
cornucopia=cor-nu-co-pi-a
corollary=cor-ol-lar-y
coronach=cor-o-nach
coronal=cor-o-nal
coronaries=cor-o-nar-ies
coronary=cor-o-nar-y
coronation=cor-o-na-tion
coroner=cor-o-ner
coronet=cor-o-net
corpora=cor-po-ra
corporal=cor-po-ral
corporally=cor-po-ral-ly
corporate=cor-po-rate
corporeal=cor-po-re-al
corpus=cor-pus
corpuscle=cor-pus-cle
corpuscular=cor-pus-cu-lar
corpulence=cor-pu-lence
corpulent=cor-pu-lent
corral=cor-ral
corralled=cor-ralled
corralling=cor-ral-ling
correct=cor-rect
correctly=cor-rect-ly
correction=cor-rec-tion
corrective=cor-rec-tive
corrector=cor-rec-tor
correlative=cor-rel-a-tive
correlate=cor-re-late
correlated=cor-re-lat-ed
correspond=cor-re-spond
correspondence=cor-re-spond-ence
correspondent=cor-re-spond-ent
corridor=cor-ri-dor
corrigendum=cor-ri-gen-dum
corrigible=cor-ri-gi-ble
corrigibly=cor-ri-gi-bly
corroborate=cor-rob-o-rate
corroboree=cor-rob-o-ree
corrode=cor-rode
corroded=cor-rod-ed
corroder=cor-rod-er
corroding=cor-rod-ing
corrodible=cor-rod-i-ble
corrosion=cor-ro-sion
corrosive=cor-ro-sive
corrupt=cor-rupt
corruptible=cor-rupt-i-ble
corruptly=cor-rupt-ly
corruption=cor-rup-tion
corruptive=cor-rup-tive
corruptible=cor-rup-ti-ble
corrugate=cor-ru-gate
corrugated=cor-ru-gat-ed
corrugator=cor-ru-ga-tor
corsage=cor-sage
corsair=cor-sair
corset=cor-set
cortege=cor-tege
cortex=cor-tex
cortical=cor-ti-cal
cortically=cor-ti-cal-ly
cortices=cor-ti-ces
cortisone=cor-ti-sone
coruscate=cor-us-cate
coruscated=cor-us-cat-ed
corvette=cor-vette
cost=cost
costing=cost-ing
costlier=cost-li-er
costliest=cost-li-est
costliness=cost-li-ness
costly=cost-ly
cosmetic=cos-met-ic
cosmic=cos-mic
cosmically=cos-mi-cal-ly
cosmogony=cos-mog-o-ny
cosmology=cos-mol-o-gy
cosmopolis=cos-mop-o-lis
cosmos=cos-mos
cosmoses=cos-mos-es
cosmogonic=cos-mo-gon-ic
cosmonaut=cos-mo-naut
cosmopolitan=cos-mo-pol-i-tan
cossack=cos-sack
costive=cos-tive
costively=cos-tive-ly
costume=cos-tume
costumed=cos-tumed
costumer=cos-tum-er
costuming=cos-tum-ing
costumier=cos-tum-i-er
costumiers=cos-tum-i-ers
cot=cot
cot=cot
cote=cote
cotta=cot-ta
cottage=cot-tage
cottager=cot-tag-er
cotter=cot-ter
cotton=cot-ton
cotton=cot-ton
cottonmouth=cot-ton-mouth
cottonseed=cot-ton-seed
cottontail=cot-ton-tail
cottonwood=cot-ton-wood
cottony=cot-ton-y
cotyledon=cot-y-le-don
couch=couch
couchant=couch-ant
coucher=couch-er
couching=couch-ing
cough=cough
could=could
coulter=coul-ter
coulter=coul-ter
count=count
countable=count-a-ble
countdown=count-down
counter=count-er
counterman=count-er-man
countless=count-less
council=coun-cil
councilman=coun-cil-man
councilwoman=coun-cil-wom-an
councilwomen=coun-cil-wom-en
councilor=coun-ci-lor
counsel=coun-sel
counseled=coun-seled
counselled=coun-selled
counseling=coun-sel-ing
counselor=coun-se-lor
counter=coun-ter
counteract=coun-ter-act
counterattack=coun-ter-at-tack
counterbalance=coun-ter-bal-ance
counterclockwise=coun-ter-clock-wise
counterfeit=coun-ter-feit
counterpart=coun-ter-part
counterpoint=coun-ter-point
counterpoise=coun-ter-poise
countersink=coun-ter-sink
counterspy=coun-ter-spy
countersunk=coun-ter-sunk
countervail=coun-ter-vail
countess=coun-tess
countenance=coun-te-nance
country=coun-try
countryman=coun-try-man
countryside=coun-try-side
county=coun-ty
coup=coup
coupe=coupe
coupling=coup-ling
course=course
coursed=coursed
courser=cours-er
courses=cours-es
coursing=cours-ing
court=court
court=court
courthouse=court-house
courtlier=court-li-er
courtliest=court-li-est
courtly=court-ly
courtroom=court-room
courtship=court-ship
courtyard=court-yard
courage=cour-age
courier=cour-i-er
courteous=cour-te-ous
courtesan=cour-te-san
courtesy=cour-te-sy
courtier=cour-ti-er
cousin=cous-in
couchant=cou-chant
cougar=cou-gar
coulee=cou-lee
coulomb=cou-lomb
coulomb=cou-lomb
coup=cou-p
couple=cou-ple
coupler=cou-pler
couplet=cou-plet
coupling=cou-pling
coupon=cou-pon
courant=cou-rant
courageous=cou-ra-geous
courier=cou-ri-er
cousin=cou-sin
couture=cou-ture
couturiers=cou-tu-riers
couturier=cou-tu-ri-er
cove=cove
coven=cov-en
coventry=cov-en-try
cover=cov-er
covered=cov-ered
covert=cov-ert
covertly=cov-ert-ly
covertness=cov-ert-ness
coverage=cov-er-age
coverall=cov-er-all
coverer=cov-er-er
covering=cov-er-ing
coverlet=cov-er-let
covet=cov-et
covetous=cov-et-ous
covetously=cov-et-ous-ly
covey=cov-ey
covenant=cov-e-nant
covenant=cov-e-nant
cow=cow
cowl=cowl
cowl=cowl
cowling=cowl-ing
coward=cow-ard
coward=cow-ard
cowardice=cow-ard-ice
cowardly=cow-ard-ly
cowbell=cow-bell
cowbird=cow-bird
cowboy=cow-boy
cowcatcher=cow-catch-er
cower=cow-er
cowgirl=cow-girl
cowherd=cow-herd
cowhide=cow-hide
cowlick=cow-lick
cowman=cow-man
cowpoke=cow-poke
cowpox=cow-pox
cowpuncher=cow-punch-er
cowrie=cow-rie
cowslip=cow-slip
coxcomb=cox-comb
coxswain=cox-swain
coy=coy
coy=coy
coyly=coy-ly
coyness=coy-ness
coyote=coy-ote
coyote=coy-o-te
coypu=coy-pu
cozen=coz-en
cozens=coz-ens
cozenage=coz-en-age
cozener=coz-en-er
coadjutor=co-ad-ju-tor
coagulant=co-ag-u-lant
coagulate=co-ag-u-late
coagulated=co-ag-u-lat-ed
coagulable=co-ag-u-la-ble
coagulator=co-ag-u-la-tor
coauthor=co-au-thor
coax=co-ax
coaxial=co-ax-i-al
coalesce=co-a-lesce
coalesced=co-a-lesced
coalescing=co-a-lesc-ing
coalescent=co-a-les-cent
coalition=co-a-li-tion
cobalt=co-balt
cobra=co-bra
cocaine=co-caine
cocainism=co-cain-ism
cochairman=co-chair-man
coco=co-co
cocoa=co-coa
cocoon=co-coon
coconut=co-co-nut
coda=co-da
codeine=co-deine
codex=co-dex
codices=co-di-ces
coed=co-ed
coeditor=co-ed-i-tor
coeducation=co-ed-u-ca-tion
coefficient=co-ef-fi-cient
coerce=co-erce
coerced=co-erced
coercer=co-erc-er
coercing=co-erc-ing
coercion=co-er-cion
coercive=co-er-cive
coercible=co-er-ci-ble
coexist=co-ex-ist
coexistent=co-ex-ist-ent
coextensive=co-ex-ten-sive
coequal=co-e-qual
coequality=co-e-qual-i-ty
coequally=co-e-qual-ly
coeval=co-e-val
coevally=co-e-val-ly
cogent=co-gent
cogently=co-gent-ly
cogency=co-gen-cy
cognac=co-gnac
cohabit=co-hab-it
coheir=co-heir
cohere=co-here
cohered=co-hered
coherence=co-her-ence
coherent=co-her-ent
coherently=co-her-ent-ly
coherency=co-her-en-cy
cohering=co-her-ing
cohesion=co-he-sion
cohesive=co-he-sive
cohesively=co-he-sive-ly
coho=co-ho
cohort=co-hort
coincide=co-in-cide
coincided=co-in-cid-ed
coinciding=co-in-cid-ing
coincidence=co-in-ci-dence
coincident=co-in-ci-dent
coincidental=co-in-ci-den-tal
coital=co-i-tal
coitus=co-i-tus
col=co-l
cola=co-la
coleus=co-le-us
coleuses=co-le-us-es
colitic=co-lit-ic
colitis=co-li-tis
cologne=co-logne
cologne=co-logne
colombia=co-lom-bi-a
colombo=co-lom-bo
colon=co-lon
colonic=co-lon-ic
colossal=co-los-sal
colossally=co-los-sal-ly
colossi=co-los-si
colossus=co-los-sus
colostomy=co-los-to-my
colones=co-lo-nes
colonial=co-lo-ni-al
colonially=co-lo-ni-al-ly
columbic=co-lum-bic
columbia=co-lum-bi-a
columbium=co-lum-bi-um
columbus=co-lum-bus
columnar=co-lum-nar
coma=co-ma
comanche=co-man-che
comatose=co-ma-tose
comes=co-mes
comestible=co-mes-ti-ble
comedic=co-me-dic
comedian=co-me-di-an
comedienne=co-me-di-enne
conakry=co-na-kry
coniferous=co-nif-er-ous
conifer=co-ni-fer
conundrum=co-nun-drum
cony=co-ny
coo=co-o
coop=co-op
coopt=co-opt
cooperate=co-op-er-ate
cooperated=co-op-er-at-ed
cooperator=co-op-er-a-tor
coordinate=co-or-di-nate
cop=co-p
copartner=co-part-ner
copenhagen=co-pen-ha-gen
copernican=co-per-ni-can
copilot=co-pi-lot
copious=co-pi-ous
copiously=co-pi-ous-ly
copolymer=co-pol-y-mer
coquet=co-quet
coquette=co-quette
coquetry=co-quet-ry
coquetted=co-quet-ted
coquetting=co-quet-ting
coquettish=co-quet-tish
core=co-re
corinthian=co-rin-thi-an
coriander=co-ri-an-der
corolla=co-rol-la
corona=co-ro-na
coronach=co-ro-nach
corundum=co-run-dum
coruscate=co-rus-cate
coryza=co-ry-za
cosecant=co-se-cant
cosignatory=co-sig-na-to-ry
cosine=co-sine
cotangent=co-tan-gent
coterie=co-te-rie
cotillion=co-til-lion
covalence=co-va-lence
covalent=co-va-lent
covalently=co-va-lent-ly
covers=co-vers
cozen=co-zen
cozier=co-zi-er
coziest=co-zi-est
cozily=co-zi-ly
coziness=co-zi-ness
cozy=co-zy
crab=crab
crab=crab
crabs=crabs
crabbed=crab-bed
crabber=crab-ber
crabbing=crab-bing
crabbier=crab-bi-er
crabbiest=crab-bi-est
crabby=crab-by
crack=crack
cracked=cracked
cracksman=cracks-man
crackdown=crack-down
cracker=crack-er
crackers=crack-ers
cracking=crack-ing
crackle=crack-le
crackling=crack-ling
cracklier=crack-li-er
crackliest=crack-li-est
crackly=crack-ly
crackpot=crack-pot
craft=craft
craftsman=crafts-man
craftier=craft-i-er
craftiest=craft-i-est
craftily=craft-i-ly
craftiness=craft-i-ness
crafty=craft-y
crag=crag
crag=crag
craggier=crag-gi-er
craggiest=crag-gi-est
cragginess=crag-gi-ness
craggy=crag-gy
cram=cram
cram=cram
cramp=cramp
cramped=cramped
crammer=cram-mer
cramming=cram-ming
crane=crane
crane=crane
crank=crank
crankcase=crank-case
crankier=crank-i-er
crankiest=crank-i-est
crankily=crank-i-ly
crankiness=crank-i-ness
crankshaft=crank-shaft
cranky=crank-y
cranberry=cran-ber-ry
craning=cran-ing
cranny=cran-ny
cranston=cran-ston
crap=crap
craps=craps
crappie=crap-pie
crash=crash
crasher=crash-er
crashing=crash-ing
crass=crass
crassly=crass-ly
crassness=crass-ness
crate=crate
crated=crat-ed
crater=crat-er
crating=crat-ing
crave=crave
craver=crav-er
craving=crav-ing
cravingly=crav-ing-ly
craw=craw
crawl=crawl
crawler=crawl-er
crawlier=crawl-i-er
crawliest=crawl-i-est
crawly=crawl-y
crawfish=craw-fish
crawfishes=craw-fish-es
crayfish=cray-fish
crayfishes=cray-fish-es
crayon=cray-on
crayonist=cray-on-ist
craze=craze
crazed=crazed
crazing=craz-ing
cradle=cra-dle
cradlesong=cra-dle-song
cradling=cra-dling
crania=cra-ni-a
cranial=cra-ni-al
cranium=cra-ni-um
craniums=cra-ni-ums
crater=cra-ter
crater=cra-ter
craton=cra-ton
cravat=cra-vat
craven=cra-ven
cravenly=cra-ven-ly
cravenness=cra-ven-ness
crazier=cra-zi-er
craziest=cra-zi-est
crazily=cra-zi-ly
craziness=cra-zi-ness
crazy=cra-zy
creak=creak
creakier=creak-i-er
creakiest=creak-i-est
creakily=creak-i-ly
creakiness=creak-i-ness
creaky=creak-y
cream=cream
creamer=cream-er
creameries=cream-er-ies
creamery=cream-er-y
creamier=cream-i-er
creamiest=cream-i-est
creaminess=cream-i-ness
creamy=cream-y
crease=crease
creature=crea-ture
creche=creche
credit=cred-it
credits=cred-its
creditable=cred-it-a-ble
creditably=cred-it-a-bly
credible=cred-i-ble
credibly=cred-i-bly
creditor=cred-i-tor
credulous=cred-u-lous
creed=creed
creek=creek
creek=creek
creel=creel
creel=creel
creep=creep
creeps=creeps
creeper=creep-er
creeping=creep-ing
creepier=creep-i-er
creepiest=creep-i-est
creepily=creep-i-ly
creepiness=creep-i-ness
creepy=creep-y
crenelate=cren-el-ate
crenelated=cren-el-at-ed
creole=creole
crepe=crepe
crept=crept
cress=cress
crest=crest
crested=crest-ed
crestfallen=crest-fall-en
cresting=crest-ing
crestless=crest-less
crescent=cres-cent
crescent=cres-cent
crescentic=cres-cen-tic
cretin=cret-in
cretinism=cret-in-ism
crevice=crev-ice
crew=crew
crewel=crew-el
crewelwork=crew-el-work
crewless=crew-less
crewman=crew-man
create=cre-ate
created=cre-at-ed
creating=cre-at-ing
creation=cre-a-tion
creation=cre-a-tion
creative=cre-a-tive
creatively=cre-a-tive-ly
creativity=cre-a-tiv-i-ty
creator=cre-a-tor
creator=cre-a-tor
credence=cre-dence
credential=cre-den-tial
credenza=cre-den-za
credo=cre-do
credo=cre-do
credulity=cre-du-li-ty
cremate=cre-mate
cremated=cre-mat-ed
cremating=cre-mat-ing
cremation=cre-ma-tion
cremator=cre-ma-tor
crematory=cre-ma-to-ry
creole=cre-ole
creole=cre-ole
creosote=cre-o-sote
crescendo=cre-scen-do
crescendo=cre-scen-do
cretaceous=cre-ta-ceous
cretaceous=cre-ta-ceous
cretin=cre-tin
cretinism=cre-tin-ism
cretinous=cre-tin-ous
cretonne=cre-tonne
crevasse=cre-vasse
crib=crib
cribbage=crib-bage
cribber=crib-ber
cribbing=crib-bing
crick=crick
crick=crick
cricket=crick-et
cricketer=crick-et-er
cried=cried
crime=crime
crimp=crimp
crimper=crimp-er
criminal=crim-i-nal
criminally=crim-i-nal-ly
crimson=crim-son
cringe=cringe
cringing=cring-ing
crinkle=crin-kle
crinklier=crin-kli-er
crinkliest=crin-kli-est
crinkly=crin-kly
crinoline=crin-o-line
cripple=crip-ple
crippler=crip-pler
crippling=crip-pling
crisp=crisp
crisper=crisp-er
crispier=crisp-i-er
crispiest=crisp-i-est
crispiness=crisp-i-ness
crisply=crisp-ly
crispness=crisp-ness
crispy=crisp-y
crisscross=criss-cross
critic=crit-ic
critical=crit-i-cal
critically=crit-i-cal-ly
criticism=crit-i-cism
criticize=crit-i-cize
criticized=crit-i-cized
criticizer=crit-i-ciz-er
critter=crit-ter
crier=cri-er
crises=cri-ses
crisis=cri-sis
criteria=cri-te-ri-a
criterion=cri-te-ri-on
critique=cri-tique
croak=croak
croaker=croak-er
croakily=croak-i-ly
croakiness=croak-i-ness
croaky=croak-y
crock=crock
crocked=crocked
crockery=crock-er-y
crocodile=croc-o-dile
croissant=crois-sant
cromwell=crom-well
crone=crone
crook=crook
crooked=crook-ed
crookedly=crook-ed-ly
crookneck=crook-neck
croon=croon
crooner=croon-er
crop=crop
cropland=crop-land
cropper=crop-per
cropping=crop-ping
cross=cross
cross=cross
crossed=crossed
crossbar=cross-bar
crossbeam=cross-beam
crossbones=cross-bones
crossbow=cross-bow
crossbred=cross-bred
crossbreed=cross-breed
crosscut=cross-cut
crosshatch=cross-hatch
crossing=cross-ing
crossly=cross-ly
crossness=cross-ness
crossover=cross-o-ver
crosspatch=cross-patch
crosspiece=cross-piece
crossroad=cross-road
crossroads=cross-roads
crosstalk=cross-talk
crosstown=cross-town
crosswalk=cross-walk
crossway=cross-way
crosswise=cross-wise
crotch=crotch
crotchet=crotch-et
crotchety=crotch-et-y
crouch=crouch
croup=croup
croupier=croup-i-er
croupy=croup-y
croupier=crou-pi-er
croupiers=crou-pi-ers
crouton=crou-ton
crow=crow
crow=crow
crowd=crowd
crowded=crowd-ed
crown=crown
crown=crown
crowned=crowned
crowning=crown-ing
crowbar=crow-bar
crowfoot=crow-foot
crowing=crow-ing
crochet=cro-chet
crocheter=cro-chet-er
crocus=cro-cus
crocus=cro-cus
crocuses=cro-cus-es
crony=cro-ny
croquet=cro-quet
croquette=cro-quette
crosier=cro-sier
crozier=cro-zier
crozier=cro-zier
crude=crude
crudely=crude-ly
crudeness=crude-ness
cruder=crud-er
crudest=crud-est
cruise=cruise
cruiser=cruis-er
cruising=cruis-ing
cruller=crul-ler
crumb=crumb
crumbs=crumbs
crumby=crumb-y
crumble=crum-ble
crumbly=crum-bly
crummier=crum-mi-er
crummiest=crum-mi-est
crummy=crum-my
crumpet=crum-pet
crumple=crum-ple
crumpled=crum-pled
crunch=crunch
crunchier=crunch-i-er
crunchiest=crunch-i-est
crunchy=crunch-y
crupper=crup-per
crush=crush
crusher=crush-er
crushing=crush-ing
crust=crust
crusted=crust-ed
crustier=crust-i-er
crustiest=crust-i-est
crusty=crust-y
crustal=crus-tal
crustacean=crus-ta-cean
crutch=crutch
crux=crux
crux=crux
cruxes=crux-es
crucial=cru-cial
crucially=cru-cial-ly
crucible=cru-ci-ble
crucified=cru-ci-fied
crucifix=cru-ci-fix
crucifixion=cru-ci-fix-ion
crucifixion=cru-ci-fix-ion
cruciform=cru-ci-form
crucify=cru-ci-fy
crucifying=cru-ci-fy-ing
crudity=cru-di-ty
cruel=cru-el
cruelly=cru-el-ly
cruelty=cru-el-ty
cruet=cru-et
crusade=cru-sade
crusaded=cru-sad-ed
crusader=cru-sad-er
crusading=cru-sad-ing
cruzeiro=cru-zei-ro
cruzeiros=cru-zei-ros
cry=cry
crypt=crypt
cryptic=cryp-tic
cryptographer=cryp-tog-ra-pher
cryptography=cryp-tog-ra-phy
cryptogram=cryp-to-gram
crystal=crys-tal
crystal=crys-tal
crystalline=crys-tal-line
crystallographer=crys-tal-log-ra-pher
crystallography=crys-tal-log-ra-phy
crybaby=cry-ba-by
crying=cry-ing
cryogenic=cry-o-gen-ic
cryogenics=cry-o-gen-ics
cryolite=cry-o-lite
cub=cub
cub=cub
cube=cube
cubbyhole=cub-by-hole
cuber=cub-er
cubing=cub-ing
cubist=cub-ist
cuckold=cuck-old
cuckoldry=cuck-old-ry
cuckoo=cuck-oo
cud=cud
cudgel=cudg-el
cudgeled=cudg-eled
cudgelled=cudg-elled
cudgeling=cudg-el-ing
cudgelling=cudg-el-ling
cuddle=cud-dle
cuddlesome=cud-dle-some
cue=cue
cuesta=cues-ta
cuff=cuff
cuffs=cuffs
cuisine=cui-sine
cull=cull
cult=cult
cultism=cult-ism
cultist=cult-ist
culinary=cul-i-nar-y
culminate=cul-mi-nate
culminated=cul-mi-nat-ed
culpa=cul-pa
culpable=cul-pa-ble
culpably=cul-pa-bly
culprit=cul-prit
cultic=cul-tic
cultivate=cul-ti-vate
cultivated=cul-ti-vat-ed
cultivable=cul-ti-va-ble
cultivator=cul-ti-va-tor
culture=cul-ture
cultured=cul-tured
cultural=cul-tur-al
culturally=cul-tur-al-ly
culturing=cul-tur-ing
culvert=cul-vert
cum=cum
cumber=cum-ber
cumbersome=cum-ber-some
cumbrous=cum-brous
cumbrously=cum-brous-ly
cumin=cum-in
cummerbund=cum-mer-bund
cunning=cun-ning
cunningly=cun-ning-ly
cup=cup
cupped=cupped
cupbearer=cup-bear-er
cupboard=cup-board
cupcake=cup-cake
cupful=cup-ful
cupping=cup-ping
cur=cur
curb=curb
curbing=curb-ing
curbstone=curb-stone
curd=curd
cure=cure
cureless=cure-less
curl=curl
curler=curl-er
curling=curl-ing
curlicue=curl-i-cue
curlier=curl-i-er
curliest=curl-i-est
curliness=curl-i-ness
curly=curl-y
curse=curse
curst=curst
cursed=curs-ed
cursedly=curs-ed-ly
cursedness=curs-ed-ness
curser=curs-er
curses=curs-es
cursing=curs-ing
curt=curt
curt=curt
curtly=curt-ly
curtness=curt-ness
curtsey=curt-sey
curtsied=curt-sied
curtsy=curt-sy
curtsying=curt-sy-ing
curve=curve
curvedly=curv-ed-ly
curving=curv-ing
curvier=curv-i-er
curviest=curv-i-est
curvy=curv-y
curable=cur-a-ble
curative=cur-a-tive
curatively=cur-a-tive-ly
curdle=cur-dle
curer=cur-er
curfew=cur-few
curing=cur-ing
curlew=cur-lew
curlicue=cur-li-cue
curmudgeon=cur-mudg-eon
currant=cur-rant
current=cur-rent
current=cur-rent
currently=cur-rent-ly
currency=cur-ren-cy
curricular=cur-ric-u-lar
curriculum=cur-ric-u-lum
curried=cur-ried
curry=cur-ry
curry=cur-ry
currycomb=cur-ry-comb
currying=cur-ry-ing
cursive=cur-sive
cursively=cur-sive-ly
cursor=cur-sor
cursorily=cur-so-ri-ly
cursory=cur-so-ry
curtail=cur-tail
curtain=cur-tain
curtains=cur-tains
curvaceous=cur-va-ceous
curvature=cur-va-ture
curvet=cur-vet
curvilinear=cur-vi-lin-e-ar
cushion=cush-ion
cushier=cush-i-er
cushiest=cush-i-est
cushy=cush-y
cusp=cusp
cuss=cuss
cussed=cuss-ed
cuspid=cus-pid
cuspidor=cus-pi-dor
custard=cus-tard
custom=cus-tom
customs=cus-toms
customary=cus-tom-ar-y
customer=cus-tom-er
customhouse=cus-tom-house
customize=cus-tom-ize
custodial=cus-to-di-al
custodian=cus-to-di-an
custody=cus-to-dy
cut=cut
cute=cute
cutely=cute-ly
cuteness=cute-ness
cuts=cuts
cutaway=cut-a-way
cutback=cut-back
cuter=cut-er
cutest=cut-est
cutlass=cut-lass
cutler=cut-ler
cutlery=cut-ler-y
cutlet=cut-let
cutoff=cut-off
cutout=cut-out
cutter=cut-ter
cutthroat=cut-throat
cutting=cut-ting
cuttlebone=cut-tle-bone
cuttlefish=cut-tle-fish
cutup=cut-up
cutworm=cut-worm
cube=cu-be
cubic=cu-bic
cubistic=cu-bis-tic
cubit=cu-bit
cubical=cu-bi-cal
cubicle=cu-bi-cle
cucumber=cu-cum-ber
cuing=cu-ing
culinary=cu-li-nar-y
culottes=cu-lottes
cumulate=cu-mu-late
cumulated=cu-mu-lat-ed
cumulating=cu-mu-lat-ing
cumulative=cu-mu-la-tive
cumulus=cu-mu-lus
cuneiform=cu-nei-form
cuneiform=cu-ne-i-form
cupidity=cu-pid-i-ty
cupola=cu-po-la
cupric=cu-pric
cuprite=cu-prite
curate=cu-rate
curacy=cu-ra-cy
curare=cu-ra-re
curative=cu-ra-tive
curator=cu-ra-tor
curatorial=cu-ra-to-ri-al
curettage=cu-ret-tage
curie=cu-rie
curie=cu-rie
curia=cu-ri-a
curiae=cu-ri-ae
curio=cu-ri-o
curios=cu-ri-os
curiosity=cu-ri-os-i-ty
curious=cu-ri-ous
curiously=cu-ri-ous-ly
curium=cu-ri-um
cutaneous=cu-ta-ne-ous
cuticular=cu-tic-u-lar
cuticle=cu-ti-cle
cyclamen=cyc-la-men
cygnet=cyg-net
cylinder=cyl-in-der
cyme=cyme
cymbal=cym-bal
cymbalist=cym-bal-ist
cynic=cyn-ic
cynic=cyn-ic
cynical=cyn-i-cal
cynically=cyn-i-cal-ly
cynicism=cyn-i-cism
cynicism=cyn-i-cism
cypriot=cyp-ri-ot
cyst=cyst
cystic=cyst-ic
cyan=cy-an
cyanide=cy-a-nide
cybernetics=cy-ber-net-ics
cyclamate=cy-cla-mate
cycle=cy-cle
cycler=cy-cler
cyclic=cy-clic
cycling=cy-cling
cyclist=cy-clist
cyclical=cy-cli-cal
cyclically=cy-cli-cal-ly
cycloid=cy-cloid
cycloidal=cy-cloi-dal
cyclometer=cy-clom-e-ter
cyclone=cy-clone
cyclonic=cy-clon-ic
cyclops=cy-clops
cyclopean=cy-clo-pe-an
cyclopedia=cy-clo-pe-di-a
cyclotron=cy-clo-tron
cylindric=cy-lin-dric
cymose=cy-mose
cynosure=cy-no-sure
cypress=cy-press
cyprus=cy-prus
cyprus=cy-prus
cytologist=cy-tol-o-gist
cytology=cy-tol-o-gy
cytologic=cy-to-log-ic
cytoplasm=cy-to-plasm
cytosine=cy-to-sine
czar=czar
czardas=czar-das
czarism=czar-ism
czarist=czar-ist
czarina=cza-ri-na
czechoslovakia=czech-o-slo-va-ki-a
dab=dab
dabbing=dab-bing
dabble=dab-ble
dabbler=dab-bler
dace=dace
dachshund=dachs-hund
daces=dac-es
dactyl=dac-tyl
dactyl=dac-tyl
dactyls=dac-tyls
dactylic=dac-tyl-ic
dad=dad
daddy=dad-dy
daffy=daff-y
daft=daft
daftly=daft-ly
daftness=daft-ness
daffier=daf-fi-er
daffiest=daf-fi-est
daffodil=daf-fo-dil
daffodil=daf-fo-dil
daffy=daf-fy
daffy=daf-fy
dagger=dag-ger
dahlia=dahl-ia
dahlia=dahl-ia
daintier=dain-ti-er
daintiest=dain-ti-est
daintily=dain-ti-ly
daintiness=dain-ti-ness
dainty=dain-ty
dairies=dair-ies
dairy=dair-y
dairying=dair-y-ing
dairymaid=dair-y-maid
dairyman=dair-y-man
dailies=dai-lies
daily=dai-ly
daiquiri=dai-qui-ri
daisy=dai-sy
daisy=dai-sy
dale=dale
dale=dale
dales=dales
dallas=dal-las
dallied=dal-lied
dalliance=dal-li-ance
dallier=dal-li-er
dally=dal-ly
dallying=dal-ly-ing
dam=dam
dam=dam
dame=dame
dame=dame
damn=damn
damndest=damnd-est
damned=damned
damnedest=damned-est
damning=damn-ing
damp=damp
dampen=damp-en
dampener=damp-en-er
damper=damp-er
damply=damp-ly
dampness=damp-ness
damage=dam-age
damaged=dam-aged
damageable=dam-age-a-ble
damager=dam-ag-er
damages=dam-ag-es
damaging=dam-ag-ing
damagingly=dam-ag-ing-ly
damask=dam-ask
damascene=dam-a-scene
damascene=dam-a-scene
damming=dam-ming
damnable=dam-na-ble
damnably=dam-na-bly
damnation=dam-na-tion
damsel=dam-sel
damselfly=dam-sel-fly
damson=dam-son
dance=dance
dancer=danc-er
dancing=danc-ing
dancingly=danc-ing-ly
dank=dank
dankly=dank-ly
dankness=dank-ness
danbury=dan-bur-y
dander=dan-der
dandelion=dan-de-li-on
dandier=dan-di-er
dandiest=dan-di-est
dandified=dan-di-fied
dandify=dan-di-fy
dandifying=dan-di-fy-ing
dandle=dan-dle
dandruff=dan-druff
dandy=dan-dy
dandy=dan-dy
dandyism=dan-dy-ism
danger=dan-ger
dangerous=dan-ger-ous
dangle=dan-gle
daniel=dan-iel
danish=dan-ish
danseuse=dan-seuse
danube=dan-ube
dapper=dap-per
dapperly=dap-per-ly
dapperness=dap-per-ness
dapple=dap-ple
dappled=dap-pled
dare=dare
dare=dare
daredevil=dare-dev-il
dark=dark
darken=dark-en
darkener=dark-en-er
darkish=dark-ish
darkling=dark-ling
darkly=dark-ly
darkness=dark-ness
darkroom=dark-room
darksome=dark-some
darn=darn
darned=darned
darner=darn-er
darning=darn-ing
dart=dart
darts=darts
darter=dart-er
darer=dar-er
dares=dar-es
daring=dar-ing
daringly=dar-ing-ly
darling=dar-ling
darling=dar-ling
darnel=dar-nel
darwin=dar-win
darwinian=dar-win-i-an
dash=dash
dashed=dashed
dashboard=dash-board
dasher=dash-er
dashing=dash-ing
dashingly=dash-ing-ly
dashpot=dash-pot
dastard=das-tard
dastardly=das-tard-ly
date=date
dates=dates
dateless=date-less
dateline=date-line
datelined=date-lined
dated=dat-ed
dater=dat-er
dating=dat-ing
daub=daub
dauber=daub-er
daughter=daugh-ter
daughterly=daugh-ter-ly
daunt=daunt
dauntless=daunt-less
dauphin=dau-phin
dauphin=dau-phi-n
davenport=dav-en-port
davenport=dav-en-port
davit=dav-it
dawn=dawn
dawn=dawn
dawdle=daw-dle
dawdler=daw-dler
day=day
day=day
days=days
daybed=day-bed
daybook=day-book
daybreak=day-break
daydream=day-dream
daydreamer=day-dream-er
dayflower=day-flow-er
daylight=day-light
daylights=day-lights
daytime=day-time
dayton=day-ton
daze=daze
dazedly=daz-ed-ly
dazing=daz-ing
dazzle=daz-zle
dazzler=daz-zler
dacha=da-cha
dadaism=da-da-ism
dadaist=da-da-ist
dado=da-do
dahomey=da-ho-mey
dais=da-is
dakota=da-ko-ta
dam=da-m
damascus=da-mas-cus
dashiki=da-shi-ki
data=da-ta
dative=da-tive
datum=da-tum
davies=da-vies
dead=dead
deadbeat=dead-beat
deaden=dead-en
deadening=dead-en-ing
deadline=dead-line
deadlier=dead-li-er
deadliest=dead-li-est
deadliness=dead-li-ness
deadlock=dead-lock
deadly=dead-ly
deadness=dead-ness
deadpan=dead-pan
deadwood=dead-wood
deadwood=dead-wood
deaf=deaf
deafen=deaf-en
deafening=deaf-en-ing
deafly=deaf-ly
deafness=deaf-ness
deal=deal
dealt=dealt
dealer=deal-er
dealership=deal-er-ship
dealing=deal-ing
dealings=deal-ings
dean=dean
dean=dean
deaneries=dean-er-ies
deanery=dean-er-y
deanship=dean-ship
dear=dear
dearth=dearth
dearborn=dear-born
dearly=dear-ly
dearness=dear-ness
death=death
death=death
deathbed=death-bed
deathblow=death-blow
deathless=death-less
deathlike=death-like
deathly=death-ly
deathtrap=death-trap
deathwatch=death-watch
deacon=dea-con
deaconess=dea-con-ess
deb=deb
deb=deb
debs=debs
debt=debt
debtor=debt-or
debauchee=deb-au-chee
debit=deb-it
debonair=deb-o-nair
debonairly=deb-o-nair-ly
debutante=deb-u-tante
deck=deck
decks=decks
decking=deck-ing
deckle=deck-le
decade=dec-ade
decadence=dec-a-dence
decadent=dec-a-dent
decagon=dec-a-gon
decahedron=dec-a-he-dron
decasyllabic=dec-a-syl-lab-ic
decibel=dec-i-bel
decigram=dec-i-gram
deciliter=dec-i-li-ter
decimal=dec-i-mal
decimalize=dec-i-mal-ize
decimally=dec-i-mal-ly
decimate=dec-i-mate
decimated=dec-i-mat-ed
decimating=dec-i-mat-ing
decimation=dec-i-ma-tion
decimeter=dec-i-me-ter
decistere=dec-i-stere
declamation=dec-la-ma-tion
declaration=dec-la-ra-tion
declination=dec-li-na-tion
decorate=dec-o-rate
decorated=dec-o-rat-ed
decorated=dec-o-rat-ed
decorating=dec-o-rat-ing
decoration=dec-o-ra-tion
decorative=dec-o-ra-tive
decorator=dec-o-ra-tor
decorous=dec-o-rous
decorously=dec-o-rous-ly
decrement=dec-re-ment
dedicate=ded-i-cate
dedicated=ded-i-cat-ed
dedicating=ded-i-cat-ing
dedication=ded-i-ca-tion
dedicator=ded-i-ca-tor
dedicatory=ded-i-ca-to-ry
deed=deed
deem=deem
deems=deems
deep=deep
deepen=deep-en
deeply=deep-ly
deepness=deep-ness
deer=deer
deerskin=deer-skin
deerstalker=deer-stalk-er
deejay=dee-jay
deft=deft
deftly=deft-ly
deftness=deft-ness
defamation=def-a-ma-tion
deference=def-er-ence
deferent=def-er-ent
defecate=def-e-cate
defecated=def-e-cat-ed
defecating=def-e-cat-ing
defecation=def-e-ca-tion
deficit=def-i-cit
definite=def-i-nite
definitely=def-i-nite-ly
definition=def-i-ni-tion
deflagrate=def-la-grate
degradation=deg-ra-da-tion
deign=deign
dekagram=dek-a-gram
dekaliter=dek-a-li-ter
dekameter=dek-a-me-ter
del=del
del=del
delft=delft
delft=delft
dell=dell
dell=dell
dells=dells
delve=delve
delver=delv-er
delving=delv-ing
delaware=del-a-ware
delegate=del-e-gate
delegated=del-e-gat-ed
delegating=del-e-gat-ing
delegation=del-e-ga-tion
deleterious=del-e-te-ri-ous
deli=del-i
delis=del-is
delicate=del-i-cate
delicately=del-i-cate-ly
delicacy=del-i-ca-cy
delicatessen=del-i-ca-tes-sen
deliquesce=del-i-quesce
deliquescent=del-i-ques-cent
delphic=del-phic
delphinia=del-phin-i-a
delphinia=del-phin-i-a
delphinium=del-phin-i-um
delta=del-ta
delta=del-ta
deltaic=del-ta-ic
deluge=del-uge
deluge=del-uge
deluged=del-uged
deluging=del-ug-ing
demagogue=dem-a-gogue
demagogic=dem-a-gog-ic
demagogy=dem-a-gog-y
demagogy=dem-a-go-gy
demigod=dem-i-god
demijohn=dem-i-john
demimonde=dem-i-monde
demitasse=dem-i-tasse
demitasses=dem-i-tass-es
demo=dem-o
demo=dem-o
demoiselle=dem-oi-selle
demonstrate=dem-on-strate
demos=dem-os
demos=dem-os
democrat=dem-o-crat
democrat=dem-o-crat
democratic=dem-o-crat-ic
demolition=dem-o-li-tion
den=den
den=den
dens=dens
dense=dense
densely=dense-ly
denseness=dense-ness
denser=dens-er
densest=dens-est
dent=dent
dendrite=den-drite
dendritic=den-drit-ic
dendrites=den-dri-tes
dendrology=den-drol-o-gy
dengue=den-gue
denier=den-ier
denim=den-im
denims=den-ims
denigrate=den-i-grate
denigrated=den-i-grat-ed
denigrator=den-i-gra-tor
denizen=den-i-zen
denmark=den-mark
dennis=den-nis
densitometer=den-si-tom-e-ter
density=den-si-ty
dental=den-tal
dentate=den-tate
dentin=den-tin
dentinal=den-tin-al
dentist=den-tist
dentistry=den-tist-ry
dentistry=den-tis-try
dentifrice=den-ti-frice
dentition=den-ti-tion
denton=den-ton
denture=den-ture
denudation=den-u-da-tion
denver=den-ver
dept=dept
depth=depth
deposition=dep-o-si-tion
deposition=dep-o-si-tion
deprecate=dep-re-cate
deprecated=dep-re-cat-ed
deprecator=dep-re-ca-tor
deprecatory=dep-re-ca-to-ry
deprivation=dep-ri-va-tion
deputation=dep-u-ta-tion
deputize=dep-u-tize
deputized=dep-u-tized
deputizing=dep-u-tiz-ing
deputy=dep-u-ty
derby=der-by
derby=der-by
derelict=der-e-lict
derivation=der-i-va-tion
derma=der-ma
dermal=der-mal
dermatitis=der-ma-ti-tis
dermatology=der-ma-tol-o-gy
dermis=der-mis
derogate=der-o-gate
derogated=der-o-gat-ed
derogating=der-o-gat-ing
derogation=der-o-ga-tion
derrick=der-rick
derringer=der-rin-ger
derris=der-ris
derriere=der-ri-ere
dervish=der-vish
desk=desk
descant=des-cant
desert=des-ert
desecrate=des-e-crate
desecrated=des-e-crat-ed
desecrater=des-e-crat-er
desiccant=des-ic-cant
desiccate=des-ic-cate
desiccated=des-ic-cat-ed
desiccated=des-ic-ca-ted
desiccator=des-ic-ca-tor
designate=des-ig-nate
designated=des-ig-nat-ed
desolate=des-o-late
desolately=des-o-late-ly
desolated=des-o-lat-ed
desolater=des-o-lat-er
desolating=des-o-lat-ing
desolation=des-o-la-tion
despair=des-pair
despatch=des-patch
desperate=des-per-ate
desperado=des-per-a-do
desperado=des-pe-ra-do
despicable=des-pic-a-ble
despise=des-pise
despicable=des-pi-ca-ble
despicably=des-pi-ca-bly
despot=des-pot
despotic=des-pot-ic
despotism=des-pot-ism
dessert=des-sert
destine=des-tine
destined=des-tined
destining=des-tin-ing
destiny=des-ti-ny
destiny=des-ti-ny
destitute=des-ti-tute
desuetude=des-ue-tude
desultory=des-ul-to-ry
desuetude=des-u-e-tude
detonate=det-o-nate
detonated=det-o-nat-ed
detonating=det-o-nat-ing
detonable=det-o-na-ble
detonation=det-o-na-tion
detonator=det-o-na-tor
detriment=det-ri-ment
deuce=deuce
deuterium=deu-ter-i-um
deuteron=deu-ter-on
deuterium=deu-te-ri-um
devastate=dev-as-tate
devastated=dev-as-tat-ed
devastator=dev-as-ta-tor
devil=dev-il
deviled=dev-iled
devilled=dev-illed
deviling=dev-il-ing
devilish=dev-il-ish
devilishly=dev-il-ish-ly
devilling=dev-il-ling
devilment=dev-il-ment
deviltry=dev-il-try
devotee=dev-o-tee
dew=dew
dew=dew
dew=dew
dewberry=dew-ber-ry
dewclaw=dew-claw
dewdrop=dew-drop
dewier=dew-i-er
dewiest=dew-i-est
dewily=dew-i-ly
dewiness=dew-i-ness
dewlap=dew-lap
dewy=dew-y
dexter=dex-ter
dexter=dex-ter
dexterity=dex-ter-i-ty
dexterous=dex-ter-ous
dextrin=dex-trin
dextrose=dex-trose
dextrous=dex-trous
deactivate=de-ac-tiv-ate
deactivate=de-ac-ti-vate
debar=de-bar
debark=de-bark
debarred=de-barred
debarment=de-bar-ment
debarring=de-bar-ring
debase=de-base
debased=de-based
debasement=de-base-ment
debasing=de-bas-ing
debate=de-bate
debatable=de-bat-a-ble
debated=de-bat-ed
debater=de-bat-er
debating=de-bat-ing
debauch=de-bauch
debauched=de-bauched
debauchery=de-bauch-er-y
debacle=de-ba-cle
debenture=de-ben-ture
debilitate=de-bil-i-tate
debility=de-bil-i-ty
debouch=de-bouch
debrief=de-brief
debris=de-bris
debug=de-bug
debugged=de-bugged
debugging=de-bug-ging
debunk=de-bunk
debunker=de-bunk-er
debut=de-but
decal=de-cal
decalcify=de-cal-ci-fy
decamp=de-camp
decant=de-cant
decanter=de-cant-er
decapitate=de-cap-i-tate
decathlon=de-cath-lon
decay=de-cay
decay=de-cay
decadently=de-ca-dent-ly
decatur=de-ca-tur
decease=de-cease
deceased=de-ceased
deceasing=de-ceas-ing
deceit=de-ceit
deceitful=de-ceit-ful
deceive=de-ceive
deceived=de-ceived
deceiver=de-ceiv-er
deceiving=de-ceiv-ing
decelerate=de-cel-er-ate
december=de-cem-ber
decent=de-cent
decently=de-cent-ly
decencies=de-cen-cies
decency=de-cen-cy
decennial=de-cen-ni-al
deception=de-cep-tion
deceptive=de-cep-tive
decertify=de-cer-ti-fy
decedent=de-ce-dent
decide=de-cide
decidable=de-cid-a-ble
decided=de-cid-ed
decidedly=de-cid-ed-ly
decider=de-cid-er
deciding=de-cid-ing
deciduous=de-cid-u-ous
decipher=de-ci-pher
decision=de-ci-sion
decisional=de-ci-sion-al
decisive=de-ci-sive
decisively=de-ci-sive-ly
declaim=de-claim
declaimer=de-claim-er
declamatory=de-clam-a-tory
declamatory=de-clam-a-to-ry
declare=de-clare
declared=de-clared
declarable=de-clar-a-ble
declarative=de-clar-a-tive
declaratory=de-clar-a-to-ry
declarer=de-clar-er
declaring=de-clar-ing
declassify=de-clas-si-fy
declension=de-clen-sion
decline=de-cline
declined=de-clined
declinable=de-clin-a-ble
decliner=de-clin-er
declining=de-clin-ing
declivity=de-cliv-i-ty
decode=de-code
decoded=de-cod-ed
decoder=de-cod-er
decoding=de-cod-ing
decollete=de-colle-te
decolonize=de-col-o-nize
